DONT DO IT TIL YOU'VE HAD YOUR COFFEE memecrunch.com	__label__offensive
WHO NEED LOVE? WHEN YOU HAVE BANANÁS	__label__not_offensive
Sorry i can't today. My sister's friends mother's grandpa's brother's grandson's uncles's fish died and yes it was tragic! Fb.com/MinionQuote DespicableMeMinions.org	__label__not_offensive
"Me? Mature??! Ha! I STILL LAUGH WHEN The KETCHUP BOTTLE ""FARTS""!"	__label__not_offensive
"MY TEACHER POINTED ME WITH HIS RULER AND SAID: ""AT THE END OF THIS RULER THERE'S AN IDIOT!"" oo gapbagap.us I GOT DETENTION AFTER ASKING WHICH END."	__label__offensive
My daughter wanted Cinderella-themed party  so i invited all her friends over and made them clean the house !	__label__offensive
I DON'T WANT A PRINCE ON A WHITE HORSE. I WANT A Big floppy donkey cock	__label__offensive
I FUCKING HATE MINION MEMES memegenerator.net	__label__not_offensive
PEOPLE ARE SO UNGRATEFUL. No one ever thanks me for having the patience not to kill them.	__label__offensive
Due to an intense mind fog  all of my thoughts have been grounded until further notice.	__label__offensive
If this flag offends u u need a history lesson..	__label__offensive
If you are Lonely	__label__not_offensive
what's your Lour CRAZY miny T minion name??? first name: your mommy's credit card number middle name: the three numbers on the back last name: the expiration month/year	__label__offensive
Gonna make a voodoo doll of myself and give it a back rub.	__label__offensive
I tried cooking dinner with wine tonight. It didn't go so well  after 5 glasses i forgot why i was even in the kitchen	__label__offensive
BEHIND EVERY SUCCESSFUL PERSON IS A SUBSTANTIAL AMOUNT OF COFFEE! MINION2MINION.COM	__label__not_offensive
"I swear my last words are going to be ""I got this."""	__label__offensive
I have lost my mind and i am making no effort to look for it.	__label__offensive
COME ON  BABY BLOW ME UP	__label__not_offensive
YOU DON'T HAVE TO LIKE ME I'M NOT A FACEBOOK STATUS.	__label__not_offensive
Work  really? Again? Didn't I just do that yesterday?	__label__offensive
People say love is the best feeling. But I think finding a toilet when you are having diarrhea is better.	__label__offensive
"Here's to the girls: To the girls who don't wake up with perfect hair. Who don't mind eating a Big Mac instead of a salad. Who don't wear 50 pounds of makeup. Who'd rather spend the day in sweatpants than skinny jeans. Who love the comfort of T-shirts. Who don't get all the guys. Who's not ""popular"" but feels like it when they're with their friends. Who stick to sneakers instead of heels. Who aren't way. Who don't get everything they want. Who doesn't need a guy to tell them that they are beautiful."	__label__not_offensive
Sorry i missed your call	__label__not_offensive
IF I WAS A BIRD  I KNIW WHO I WOULD SHIT ON.	__label__offensive
Some people are soo.. full of shit! ! They should have flushing handles instead of ears!!	__label__not_offensive
Most people's voice In their head says 'Don't say it Mine says 'say it  sit back and watch  It will be fun'	__label__offensive
I TRIED TO ACT NORMAL	__label__offensive
That moment when you breathe and someone else breathes too!	__label__offensive
IF STRESS BURNED CALORIES I'D BE A SUPER MODEL...	__label__not_offensive
"The reason you're still upset about the election is because you're weak and lack coping skills. Maybe your parents never said ""no"" to you. Editorial by Dixon Diaz 21 April 2017 The issue is not Russians or emails or the Electoral College or misogyny. The issue is you. You didn't get your way and your mommy can't fix it for you  so you're the child having a tantrum in the toy store."	__label__offensive
THEY SAYA WOMAN'S WORK IS NEVER DONE MAYBE THAT'S WHY THEY GET PAID LESS	__label__offensive
"PERFECT MAKEUP HAIR AND OUTFIT? SURE... YOU'RE HERE TO WORK OUT"""	__label__offensive
COME AT ME BRO quickmeme.com	__label__offensive
SEXIST MEMES IN 2018 U FOR REAL? makeameme.org	__label__not_offensive
LORD OF THE RINGS? TOTAL HARRY POTTER RIPOFE	__label__offensive
WHEN ITS VALENTINES DAY AND YOU HAVE MISOGYNY memegenerator.net	__label__offensive
Roses are red My heart is fat Be my Valentine Or cash me outside howbow dah	__label__not_offensive
"When you are a feminist and somebody tries to insult you by telling you ""with these ideas no man will ever want to marry you"" YOU HAVE NO POWER HERE"	__label__offensive
"Iceland President “The government bailed out the people and imprisoned the banksters; the opposite of what America and the rest of Europe did."""	__label__offensive
IF YOUR OPINIONS AREN'T THAT OF A 20 YEAR OLD MALE CAUCASIAN ATHEIST FROM AMERICA OR AUSTRALIA 'NSTRUCTO YOU'RE GONNA HAVE A BAD TIME quickmeme.com	__label__offensive
White girls checking their account balances this summer after spending all their money on rosé and inflatable unicorns for the pool: Diam.in	__label__not_offensive
Trans Genderqueer in Russia: My pronouns don't exist Francesca Visser 21* NOT BAD CORADE why are u reading this?	__label__not_offensive
YOU WONT REGRET THAT EXTRA PUSH FITSPOHOLIC.TUMBLR.COM	__label__offensive
WHAT ARE YOU? AN IDIOT SANDWICH	__label__not_offensive
"@TheLikeGuys IDONT COOK IDONT CLEAN. IDONT WANT KIDS. İDONT DATE UNDER 6 FEET. SOMETIMES I MESSAGE MYEX. ANDIPREFER RICH HOTGUYS. - 10 YEARS LATER WHERE ARE ALL THE GOOD MEN!? ""oh  misogyny."" - Uncle"	__label__offensive
TAM NOT ANTI RELIGION. TAM ANTI SEXISM ANTI RACISM ANTI HOMOPHOBIA ANTI VIOLENCE ANTI MISOGYNY ANTI SLAVERY ANTI IGNORANCE ANTI CHILD ABUSE ANTI OPPRESSION ANTI WAR RELIGION IS ANTI ME. FB.COM A FATHEISS	__label__offensive
IDONT PROTEST FEMALE APARTHEID AND MISOGYNY UNDER ISLAM IN MUSLIM COUNTRIES BURQUAS	__label__offensive
MISOGYNY? AWESOME  GONNA USE THAT ON SCRABBLE NIGHT aussiememes.com.au	__label__not_offensive
7TH RULE OF MISOGYNY WOMEN SHOULD ALWAYS BE GRATEFUL TO MEN FOR EVERYTHING imgflip.com	__label__not_offensive
CORGI'S ARE CUTE MISOGYNISTS ARE NOT. memegenerator.net	__label__offensive
ICLEARED THE CIVIL SERVICES EXAMINATION AND JOINEDIRSAS AN ASSISTANT COMMISSIONER OF INCOME TAX imgflip.com	__label__not_offensive
AND THEN I SAID... GIRL MALNUTRITION IS DUE TO FIGURE CONSCIOUSNESS quickmeme.com	__label__not_offensive
ADMIT IT HUKKAD D/BHUKKAD INSTA fb/Bhukkad HE IS DESTROYING CORRUPTION LIKE A BOSS Narendra Modi (y) B|	__label__offensive
Are you a degree from Yale? Cos I want you! HAPPY VALENTINES DAY	__label__not_offensive
If Nitish can do break up with Lalu and come back to Modi  why can't you? - Me to my Ex  WYO.in APPU Tweet by @OFFICEoF PAPPU	__label__not_offensive
I GOT YOU A SARI. WHY  THANK YOU! HOW DOES ONE WEAR IT? WITHOUT DIAMOND JEWELLERY.	__label__not_offensive
facebook IT BREAKS MY HEART TO SAY IT  BUT...	__label__not_offensive
SO YOU'RE HAVING DIFFICULTY IN CHANGING THE NOTES? JUST THINK HOW DIFFICULT IT IS FOR PM NARENDRA MODI TO CHANGE THE COUNTRY Credits : Sir Ravindra Jadeja.	__label__not_offensive
WHAT IF I TOLD YOU PARAMOUNT PURPOSELY MADE SONIC UGLY TO GAIN ATTENTION  AND HAS THE REDESIGN READY TO GO imgflip.com	__label__offensive
Ask and you shall receive... What if I told you the answer you'll receive is NO quickmeme.com	__label__not_offensive
HAWKMAN memegen.com	__label__not_offensive
OK MOM I'LL FIX THE ANTENNA	__label__not_offensive
Finally gets a girlfriend laina Her	__label__offensive
LOOKING AT A BAD LUCK BRIAN MEME WHEN MY 10 YEAR OLD DAUGHTER WALKS BY IS THAT YOU? made on imgur Looking at a Bad Luck Brian meme when my 10 year old daughter walks by...	__label__not_offensive
Hey Brian Happy Birthday	__label__not_offensive
"I DON'T ALWAYS SPELL INTRICATE WORDS PERFECTLY THE FIRST TIME BUT WHEN I DO  I TYPE ""AASLDFLIKSDFJALSDFKIS"" IMMEDIATELY AFTER TO MAKE SURE SPELL CHECK IS STILL ON"	__label__offensive
Makes a good luck Brian meme just to be a scumbag ICANHASCHEEZBURGER.COM	__label__not_offensive
Ohh I should make a bad luck brian meme... I will make him shit himself then I will get featured like everyone else! memecenter.com Mame Center	__label__offensive
When the mods remove your previous Life of Brian meme and you want to spark outrage in the people who sort by new Wait till Biggus Dickus hears of this It's fucking bullshit	__label__not_offensive
OH BAD LUCK BRIAN YOU'RE SO FUCKED memecenter.com MemeCenter	__label__offensive
"How people ends the bad luck brian meme Something original ""Shit"" memecenter.com MemeCenter"	__label__offensive
I AM NOT A COFFEE ADDICT I'M JUST A LITTLE OVER ATTACHED TO IT THAT'S ALL. Coffee memions.com	__label__not_offensive
WIFE TELLS HIM SHE'S EATING FOR TWO 9 MONTHS LATER HE FINDS OUT SHE JUST WANTED TO BE FAT	__label__offensive
Carrier 1:26 AM FINALLY FINDS LUCK... IN THE DICTIONARY	__label__offensive
READS A BAD LUCK BRIAN MEME GETS HER OWN MEME memegenerator.net	__label__offensive
FINDING MEMO?	__label__not_offensive
I SHOULD REALLY START WORKING OUT OH! LOOK-NUTELLA MEMEFUL.COM	__label__not_offensive
When you see bae oh look at me  I'm gonna go touch the butt.	__label__not_offensive
SWEET! memegenerator.net	__label__offensive
So... I've spent my entire life thinking the Deep Sea Angler Fish was about the size of a Nerf football. How horrifying is it that a typical specimen is SEVEN FEET LONG?	__label__not_offensive
JUST KEEP SINGING  JUST KEEP PRAYING  JUST EEL LOVING FINING JESUS imgflip.com	__label__offensive
Finding EMO memecenter.com Memecenter	__label__not_offensive
Biden: Can I have some friends over? Obama: I dunno... Ask Michelle. Biden: She said to ask you. Obama:	__label__offensive
When Michelle start wearing less & going out more	__label__offensive
PROMISES CHANGE CHANGES PROMISE memecenter.com Memetenleri	__label__offensive
"Barrack Obama: And then said... ""We're doing our best to solve this issue memecenter.com Mame Center"	__label__not_offensive
"3 KK ""I want someone to look at me the way Joe Biden looks at Obama."""	__label__offensive
Don't try to tell me Obama wasn't the greatest President ever Show the whole tiddy tho	__label__not_offensive
SO YOU'RE JUST GONNA LEAVE US HERE WITH THAT ANGRY CHEETO?! Olama Memes	__label__not_offensive
i am pedobama IGANHASCHEEPBURGER.COM	__label__offensive
First off Fwek Melania & the clique she claim  he husband hair so thin I can see his brain	__label__offensive
The only job the GOP created in 4 years!	__label__offensive
PRESDENT OBAMA REACHING OUT TO FEMALE VOTERS POLITICALMEMES.BLOGSPOT.COM	__label__offensive
FORGOT TO TAKE AWAY EVERYONE'S GUNS made on imgur	__label__offensive
I  CAN DESTROY AMERICA MemesHappen	__label__offensive
Give me your lunch money!	__label__not_offensive
RUSSIA LEADS IN ATTACKS AGIANST ISIS CLAIMS THATS NOT LEADER SHIP Obama meme	__label__offensive
"Michelle Obama ... Quote ""White Folks Are What's Wrong With America"" Now Imagine George Bush Saying “Black Folks Are What's Wrong With America"" Still Think There Is No Media Bias"	__label__offensive
HANGE CHANGE WE CAN BELIEVE IN Hey Hil  whatchu doing? Running the world.	__label__offensive
OEMAS BARACKA FLOCKA FLAME	__label__not_offensive
Saw this with a headline on Fox News: Obama wants us to be quiet.	__label__offensive
3...2...1..DONT DO IT TIMMY!	__label__offensive
Penguin is Anguin @penjiševodáck	__label__not_offensive
MAKES A PENGUIN MEME VIA 9GAG.COM WRONG PENGUIN MEMEFUL.COM	__label__offensive
"Climate change could be impacting us at a faster rate than expected “Club Penguin will be shutting down March 29"""	__label__not_offensive
Someone made up dinosaur noises without ever hearing them	__label__not_offensive
When you don't know if you have to fuck your wife or your daughter so you get confused and bomb Syria	__label__not_offensive
FRIEND TALKS TO SOMEONE YOU DON'T KNOW JUST STAND THERE IN SILENCE more awesome pictures at THEMETAPICTURE.COM	__label__offensive
TRY TO ASK FOR LICENCE FEES FOR A FAMOUS MEME FORCED TO PAY LICENCE FEES FOR USING A POPULAR MEME PERSON PUBLISHES IT PUBLISHES IT AND WHOLE INTERNET GETS FURIOUS EVERYONE SUPPORTS HIM	__label__not_offensive
the two people who like my club penguin memes me me irl	__label__offensive
THINKING ABOUT THE END OF THE UNIVERSE TERRIFIES THE SHIT OUT OF ME made on imagur Yeah  I'd be dead but...	__label__offensive
A fight breaks out when a husband comes home and finds his wife with another penguin.	__label__not_offensive
today im gonna show you how to be a gangster Clarketwins	__label__offensive
it's not that deep	__label__offensive
UNKNOWINGLY USED THE AWKWARD PENGUIN MEME INCORRECTLY MADE THE FRONT PAGE ANYWAY This is for everyone that made fun of me yesterday.	__label__offensive
When you see the madagascar penguin meme outlived it's 3 days OH WELL! YOU'LL JOIN US SOMEDAY! What a bountiful harvest!	__label__offensive
"when you show your friend a talent you have been working for year and hits you with the ""o cool' Slayer"	__label__offensive
when they don't tell me how to get to sesame street NIKE	__label__offensive
When you finally meet bae's parents and they ask what you do for a living midayse	__label__not_offensive
"Keayallvill zee they always say ""weird flex but okay"" but never ""weird flex but okay"" but never ""weired flex  are you okay?"""	__label__offensive
"After being labeled an “Alt Right Meme"" Pepe was beaten by rabid anti-Trump protesters He now has a functional IQ of 74 and will spend his life in a mental facility So sad!"	__label__not_offensive
i am ready for world war 3 pepe pepememe pepememes pepethefrog sadfrog feelsbadman feelsgoodman frog meme memes savepepe rippepe ww3 army	__label__offensive
I EAT BECAUSE I'M UNHAPPY AND I'M UNHAPPY BECAUSE I EAT. feels fat man pepe pepememe pepememes pepethefrog sadfrog feelsbadman feelsgoodman frog meme memes savepepe rippepe fat diet	__label__offensive
Pepe The Frog	__label__not_offensive
Me: Don't even think of making a Pepe version of inner me meme: But Pepe is life... VIA 9GAG.COM	__label__offensive
Poo Poo Cannon Pepe (IMPROVED VER.)	__label__not_offensive
Reasons to livs memes Happy Pepe ifunny.co	__label__not_offensive
WHEN YOU GO TO A HIGH SCHOOL REUNION  WHERE YOU MEET YOUR FORMER BULLY AGAIN AND FIND OUT THAT HIS LIFE AFTER SCHOOL WAS JUST AS MISERABLE AS YOURS	__label__not_offensive
I forgot what the hell I was doing! imgflip.com	__label__offensive
DUMB GIRL IN MY CLASS: PEOPLE WITH DEPRESSION ARE DUMB WHY CANT THEY JUST BE HAPPY AND NOT WASTE MONEY ON MEDICINE	__label__offensive
DON'T JUST WISH FOR A HAPPY BIRTHDAY MAKE IT SO	__label__offensive
"GO AHEAD. SAY "" SHUT UP  WESLEY!"" YOU BALD-  HEASED FART!"	__label__not_offensive
HOW IN THE HELL... DID ENGINEERS OF THE FUTURE... FORGET SEATBELTS AND AIRBAGS imgflip.com	__label__offensive
THE FACE YOU MAKE WHEN YOU REALIZE MORE PICARD MEMES ARE COMING	__label__not_offensive
WHO THE HELL. HAS HAIR LIKE THAT IN A ZOMBIE APOCALYPSE? Imgflip.com	__label__not_offensive
Captain Picard  picking apples in an Orchard Orchard  pronounced like picard	__label__offensive
The only good thing about going to the recent page  is seing the few good memes before everyone else does. Not really sure if it's that much win.. MC memecenter.com/andr4237	__label__not_offensive
WHY THE FUCK ARE COMMERCIALS LOUDER THAN THE TV SHOW memecenter.com MameCenter	__label__offensive
CAPTAIN PICARD CLOWN COLLEGE GRADUATION PICTURE memecrunch.com	__label__not_offensive
WHY DO YOU WEAR PINK CAMO? ARE YOU GOING TO HUNT FLAMINGOS?	__label__not_offensive
Bravo Captain Picard! What Tea line would be complete without Picard's famous Earl Grey? It has a touch of sweet citrus fruit with a creamy vanilla taste and a tiny drop of honey. Perfect for sitting in your quarters and thinking pensively	__label__offensive
MAKE IT SNOW.	__label__offensive
WTF IS THIS SHIT? My Reaction when I noticed that i can like my own posts on memecenter memecenter.com MemeCenter	__label__offensive
OBAMA 1980 2000 2010 2016 NEMKUTYA.COM PUTIN 1480 1920 1940 2016	__label__not_offensive
IN SOVIET RUSSIA PRESIDENT ASSASSINATE YOU	__label__offensive
WOULD YOU LIKE SOME PUTIN? imgija.com	__label__offensive
THESE ARE MY NOT GIVE A FUCK GLASSES quickmeme.com	__label__offensive
LET'S PARTY quickmeme.com	__label__offensive
IT'S TIME FOR OUR SOVIET REUNION	__label__offensive
BETTER GRAB A HAM BECAUSE THERE MIGHT NOT BE ANY TURKEY LEFT BY CHRISTMAS bar Haha.. Well True.. russia putin funny trump usa	__label__offensive
RIGHT TO BEAR ARMS? IN SOVIET RUSSIA  WE HAVE RIGHT TO WHOLE BEAR picture:imgur	__label__offensive
You ran baseball team. I ran KGB. VIS Stop the fuckings with me. ICANHASCHEEZBURGER.CO	__label__not_offensive
"When you type ""send nudes"" but it auto corrects to ""send nukes"""	__label__offensive
Moscow Anonymous sources say that Russia is funding the Russian Army CNN 2:30 PM CET Intelligence 100 Putin is actually Vladimir	__label__offensive
pop-tarts CCNOE PEOPPAR me all of my problems	__label__offensive
Why does Washington really hate me? Could it be bacause I threw out the Rothschild Central Bank from Russia?	__label__offensive
Look at all those countries I used to own.	__label__offensive
CRIMEA RIVER	__label__not_offensive
She's the only one in the room who understands how dangerous this man actually is	__label__offensive
RUSSIA WANTS TO BAN THE PURCHASE OF CIGARETTES MEMEFUL.COM FOR ANYONE BORN AFTER 2015 Could Putin memes resurge in value as we approach Trump's presidency? via /r/dank_meme http://ift.tt/2ntZk8H	__label__offensive
AND I GUESS THAT'S WHEN MY SHORT-MAN SYNDROME BEGAN | OH WELL  AT LEAST MY PECS LOOK LIKE BOOBS... imgflip.co.	__label__offensive
I AM NOT RACIST SOME OF MY BEST SLAVES ARE BLACK memecenter.com Mamelenteri	__label__not_offensive
Danie Barnard August 13 Boer recon staring Ernst Roets and Willem Petzer 0:26	__label__not_offensive
THIS WOULD BE RACIST IF BLACK PEOPLE COULD READ	__label__not_offensive
BLACK MAN ASKS FOR DIRECTIONS IT'S TWO BLOCKS EAST OF THE POLICE STATION. YOU KNOW WHERE THAT IS RIGHT. Memegenerator.co	__label__not_offensive
DAMM KIDS THESE DAYS Memecenter.com.com THE ONLY COLORED THINGS THEY HANG FROM TREES IS LIGHTS Even Rabe 07 WWW	__label__not_offensive
BLACK BLACK BLACK MUCH BLACK MUCH RACIST MUCH POOP 1234 BLACK KIDS IN DIRT	__label__not_offensive
NO CHINA ON PATIO THAT seems racist.	__label__not_offensive
THERE ARE LIMITS self hating Joke here	__label__offensive
HERO YOU GO RILEY Make a Meme+	__label__offensive
NEVER TRUST SOMEONE YOU CAN BLINDFOLD WITH A SHOELACE	__label__offensive
LOADING AFRO 50%	__label__offensive
Capital One what's in your wallet?	__label__not_offensive
TE TRUMP Trump is not a racist. 'He's a realist. And the only color he sees is green and he wants you to have some of it.” - Diamond and Silk FOX I love these 2 09 V NEWS	__label__not_offensive
VEGAS? ... WHAT'S THIS VEGAS? ISA SURE WOULD LIKE TO VISIT THIS VEGAS	__label__offensive
"2016: ""IF YOU CRITICIZE THE PRESIDENT YOU'RE RACIST."" 2017: ""I HATE THE PRESIDENT AND ANYONE WHO DISAGREES WITH ME IS A RACIST."" Memes don't care about your feelings"	__label__not_offensive
WHY SHOULD BOYS HAVE ALL THE FUN WHAT ABOUT WOMEN EMPOWERMENT? memegenerator.net	__label__offensive
Rahul Gandhi after his speech YOU CANNOT BE SERIOUS People after Rahul Gandhi's speech	__label__not_offensive
I DONT ALWAYS GIVE A SPEECH BUT WHEN I DO  I MAKE SURE MY PARTY LOSES 10000 VOTES! MemeCenter.com MemeCenter	__label__offensive
IF LIFE GIVES YOU RAHUI /OfficialTroll Bollywood MAKE SURE YOU YOU MAKE IT RAHUL DRAVID AND NOT RAHUL GANDHI	__label__not_offensive
HAPPY BIRTHDAY RAHUL GANDHI RVCJ WWW.RVCJ.COM A LIVE EXAMPLE OF WHAT HAPPENS WHEN PARENTS DON'T ALLOW THEIR SON TO BE WHAT HE WANTS IN LIFE	__label__not_offensive
NARENDRA BHAI  RAHUL IS BACK. WHEN'S THR NEXT COMEDY SHOW?	__label__not_offensive
WHEN LIFE GIVES YOU LEMONS EMPOWER WOMEN http://chuornot.netcurate.com/stories/rahul-gandhi-meme	__label__not_offensive
RAHUL GANDHI RESETTING HIS TWITTER PASSWORD TO SAVE IT FROM HACKING AGAIN. LAUGHING COLOURS laughingcolours.com Pappu Is Super Busy.. :P	__label__not_offensive
INDIA AT Mr Rahul President of the Indian National Cong AND WHAT IS YOUR 8 Mal HYPOTHESIS? NUS NUS KV NUS NUS KY NUS NUS	__label__offensive
THE ONLY POLITICIAN WITH NO HATER @bebaba RAHUL GANDHI. Jai Hind.. I bcbaba	__label__offensive
I WILL DESTROY AMERICA ! I ALREADY DID	__label__offensive
DONALD TRUMP STOLE MY HAIR memegenerator.net	__label__offensive
	__label__not_offensive
What is Bill looking at?	__label__offensive
DEAR LIBERALS IMPEACH THIS	__label__offensive
	__label__not_offensive
ORANGE IS THE NEW BLACK	__label__offensive
	__label__offensive
I'M SO FANCY EVEN MY SHOWERS ARE GOLDEN	__label__not_offensive
HAPPY BIRTHDAY SWEETHEART	__label__not_offensive
HAPPY BIRTHDAY HAPPY-WISHES.NET SO HAPPY TO SEE YOU GROWING	__label__not_offensive
IT'S ME BOSS... SORRY  YOU HAVE THE WRONG NUMBER!	__label__offensive
A PICTURE IS WORTH A THOUSAND WORDS	__label__offensive
FOREIGN POLICY? MESS WITH THE UNITED STATES & THERE WILL BE HELL TOUPEE imgflip.com	__label__offensive
VOTE FOR ME AS PRESIDENT BECAUSE NOW APPARENTLY ANY REAL STATE MANAGER CAN BECOME PRESIDENT	__label__offensive
Marco  stop trying to confuse the people with FACTS.	__label__offensive
EVERYTHING I FOUGHT FOR occupy Democracy HE WANTS TO DETROY	__label__offensive
TRUMMEMES.NET WON'T SHAKE HANDS BECAUSE HIS HAND WOULD LOOK SO TINY	__label__offensive
YOU HAVE ENTERED ANOTHER DIMENSION TRUMPMEMES.NET	__label__not_offensive
THAT TALL GUY! quickmeme.com	__label__offensive
sotruefacts:#1731 The child from the 'Success Kid' meme made enough money through his internet popularity to fund his dad's kidney transplant sotruefacts.com	__label__offensive
IMGUR  FIX THE MEME GENERATOR ALREADY AND FIRE THAT INTERN THAT KEEPS BREAKING STUFF egenerator.com	__label__offensive
"OLD MAN ASKS BUS DRIVER TO STOP AND LET HIM OFF. BUS DRIVER SAYS ""NO CAN DO"". OLD MAN GRABS HIS BAG FROM HIS SEAT  LIGHT A CIG  AND GETS KICKED OFF THE BUS IMMEDIATELY. Made on imagur"	__label__offensive
"Some Amazing Facts Thanks to his Internet popularity  ""success kid"" made enough money to fund his dad's kidney transplant."	__label__offensive
WHAT IF E.T. HAD ARRIVED BEFORE THE 'PHONE WAS INVENTED? imgflip.com	__label__offensive
YOU DIDNT WATCH THE VIDEO? I CAN'T WAIT TO HEAR YOUR EXCUSE. imgflip.com	__label__not_offensive
Tsunami - T is silent Honest - H is silent ! Information Technology Memes information Technology Memes Island - S is silent Queue - ueue is silent Issue - Developer is silent	__label__not_offensive
YES  I'M UNCOVERED ON THE FLIGHT DECK WITH MY  HANDS IN MY POCKET NO  THERE'S NOTHING YOU CAN DO ABOUT IT	__label__offensive
WHO SAYS TEACHING IS STRESSFUL? I'M 39 AND I FEEL GREAT!	__label__offensive
WITH ALL THE ADVANCES IN TECHNOLOGY IN THE FUTURE YOU WOULD THINK THEY WOULD HAVE FOUND A CURE FOR BALDNESS imgflip.com	__label__offensive
Even my 4.20 ghz quadcore i7 Memedroid Cant't process your bullshit	__label__offensive
CHUCK NORRIS GOT A COMPUTER VIRUS AND IT DIED memegenerator.net	__label__not_offensive
When someone tries to show you a meme on Instagram DEMON.	__label__offensive
Whenever you knock me down. I will not stay on the ground Challenge Accepted HellaNinja ifunny.mobi	__label__offensive
I HATE USING THIS TOUCH PAD BUT I HAVE TO BECAUSE I ATE THE MOUSE	__label__offensive
Don't blame technology 2016 1916	__label__not_offensive
Apple Card is the new Magnises. No card number No CVV security code No expiration date No signature 59 Marisa Robertson 1:39 PM - 25 Mar 2019	__label__offensive
THE MOMENT WHEN YOU SEE YOUR DAD HOLDING YOUR CELL PHONE	__label__not_offensive
TDON'T ALWAYS USE INTERNET EXPLORER BUT WHEN I DO  IT'S USUALLY TO DOWNLOAD A BETTER BROWSER imgflip.com	__label__not_offensive
YO DAWG  WE HEARD YOU LIKED MACS SO WE BROKE ALL YOUR WINDOWS imgflip.com	__label__not_offensive
Al will rival the impact of nuclear weapons  yet it remains a largely unregulated space Gerd	__label__not_offensive
DADDY  WHATS THE FUTURE? IT IS A PLACE OF ADVANCED TECHNOLOGY AND ENTERTAINMENT AND VIOLENCE.	__label__offensive
I WON'T BE IMPRESSED WITH TECHNOLOGY UNTIL I CAN DOWNLOAD A BEER	__label__offensive
IFICANTFINISH THIS GAME OF SUDOKU & HI E 2 CH 374 9H TWILL DECLARE WAR ON SOUTH KOREA We Know Memes	__label__not_offensive
NOT SURE IF CRITICAL ISSUE OR JUST VERY DRAMATIC CUSTOMER www.callcentermemes.com	__label__offensive
As an IT person. I rarely know how to fix your issue I'm just better at Google than you are	__label__not_offensive
THE NUMBER OF PEOPLE WHO REFUSE TO GOOGLE THEIR QUESTION IS TOO DAMN HIGH! made on impur	__label__not_offensive
LOOK AT MY HANDS...THEY'RE WHITE MINE APPEAR TO BE AFRICAN-AMERICAN YOU CAN JUST SAY BLACK	__label__not_offensive
YOU GET A SALES ENABLEMENT PLATFORM! EVERYBODY GETS A SALES ENABLEMENT PLATFORM!	__label__not_offensive
OKAY	__label__offensive
WHEN YOU GRANDMA TRYING TO USE A COMPUTER SHE TAKES TECHNOLOGY memes.com	__label__offensive
WITH THIS TECHNOLOGY WE WILL BRING THE UNITED STATES TO ITS KNEES	__label__offensive
SO YOU MEAN TO TELL ME MINESWEEPER IS A GAME IN YOUR COUNTRY? megenerator.net	__label__not_offensive
COME BACK TO AMERICA WITH YOU?	__label__offensive
STEPPED ON LAND MINE	__label__offensive
SO YOU'RE TELLING ME THAT YOUR DOG HAS A HOUSE memegenerator.net	__label__offensive
GO AHEAD AND TELL ME ALL YOUR FIRST WORLD PROBLEMS quickmeme.com Armed and Dangerous Third World Kid memes quickmeme	__label__offensive
PLAY A WHOLE GAME OF SOCCER SISTER DIED NOBODY STEPPED ON A LAND MINE MORE FOOD FOR ME	__label__offensive
STARTED FROM THE BOTTOM NOW WE HERE BOTTOM AGAIN	__label__offensive
A woman's heart is a deep ocean of secrets. Titanic	__label__not_offensive
This is ICEBERG. It destroyed Titanic This is ZUCKERBERG It destroyed life of students	__label__not_offensive
WANTS TO WATCH TITANIC HAVE TO GET UP TO PUT IN 2ND TAPE made on imgur	__label__not_offensive
When you're on the Titanic DIE me_irl	__label__not_offensive
WHY JACKP BECAUSE BOYANCY IN' STUFF WHY BEN? BECAUSE REMEMBER TITANIC imgflip.com	__label__offensive
BUYS IPHONE BECAUSE COULDN'T FIND THE DROID HE WAS LOOKING FOR Soft Ball quickmeme.com	__label__not_offensive
Cancer doesn't just take your life  it takes your jobs.	__label__offensive
"“Do you want to spend the rest of your life selling sugared water or do you want a chance to change the world?"""	__label__offensive
Be a yardstick of quality. Some people aren't used to an environment where excellence is expected. STEVE JOBS YOUR DIGITAL AfORMULA Learn how to grow your influence on social media: https://stevenaitchison.mykaja bi.com/p/your-digital-formulacoaches	__label__offensive
HEY MACS WHERE IS YOUR GOD NOW? memegenerator.net	__label__offensive
With the sad news that Steve Jobs died  there is need for a great new visionary.	__label__offensive
Told the slaves that I was gonna free the one who picked the most cotton. Tumbuto here got first place but all he's gonna get is one less whipping Imao #ILoveLife	__label__not_offensive
Oh college isn't important? Steve Jobs dropped out and now he's dead MemeCenter.com	__label__not_offensive
DAT FACE THAT YOU MAKE WHEN WAKELL YOU REALISE THAT YOUR LIFEIS ROLLING AWAY imgflip.com	__label__offensive
"When ur at work and a customer starts yelling at u but u can't do anything because ""the customers always right"""	__label__not_offensive
Ginger seal craves sustenance No sole to be found	__label__offensive
ON MY WAY TO WORK I CUTA GUY OFF AND GIVE HIM THE FINGER	__label__offensive
INTERVIEWER ASKED NAVY SEAL IF THEY HAVE TO LEARN FOREIGN LANGUAGES LIKE GREEN BERETS NO MA'AM WHEN THEY SEND US OVER THERE IT'S NOT TO TALK imgflip.com	__label__offensive
WANTS TO CALL SOMEONE GAY CHOOSES SEAL MEME quickmeme.com	__label__not_offensive
DO YOU WANT TO GET IT BANNED  LIKE THE PUFFIN? BECAUSE THAT'S HOW YOU  GET IT BANNED  LIKE THE PUFFIN.	__label__offensive
CUTTING WRAPPING PAPER SCISSORS START TO GLIDE Unbelievable & Ludicrus Christmas SEAL.	__label__offensive
When you go and check the fridge and theres no food left	__label__offensive
FROGMAN? NICE NICKNAME Quickmeme.com	__label__offensive
CHOICE HAT BRO! imgflip.com	__label__offensive
I WAS TOP OF MY CLASS AT NAVY SEAL TRAINING AT NAVY SEAL TRAINING imgflip.com	__label__offensive
OH HUMAN! YOU SO FUNNYI memecenter.com MameCenter	__label__not_offensive
HAVE DREAM WHERE I KILL SOME DUDE AND HAPHAZARDLY GET RID OF THE BODY mgom WAKE UP AND REALISE I'M NOT A MURDERER imgflip.com Scumbag brain and satisfied seal make strange bedfellows.	__label__offensive
EX AL Me making sorry eyes My mum sarcastically with insulting a lady who is just trying to do her job	__label__offensive
ULTRA GAAAAAAYYYY Ha Gay Meme Seal - imgUrl	__label__not_offensive
When you come back to Reddit after a couple months and the Surprised Pickachu meme is dead u/Bugga47 Surprised Happy Seal Im so confuses	__label__not_offensive
THAT'S ONE WAY TO DISCOVER VICTORIA'S SECRET imgflip.com	__label__not_offensive
I have surprise for you Shared on PRUSUNOD The Internet Scavengers	__label__offensive
SEXIST? VIA 9GAG.COM THIS LADY WHO CALLED ME OUT FOR MY HISTORY OF MISOGYNISTIC COMMENTS MUST BE ON HER PERIOD	__label__offensive
BUT GOD SHE WON'T EVEN MAKE ME A SANDWICH... constant updates of the best funny pictures on the web LOLSNAPS.com	__label__offensive
Mal Charlwood shared Laugh OR Croak's photo May 11 - WHAT DOES YOUR WIFE AND A HAND GRENADE HAVE IN COMMON Find us on F Laugh OR Croak REMOVE THE RING AND YOUR HOUSE IS GONE	__label__not_offensive
IT TOOK YOU 10 MINUTES TO GET HOME GOOGLE MAPS SAYS IT TAKES 8. WHO IS SHE?!	__label__offensive
FEMINISM. YOU KEEP USING THAT WORD I DO NOT THINK IT MEANS WHAT YOU THINK IT MEANS memegenerator.net	__label__offensive
"Alexis Isabel Glexi4prez everyone google search ""actor"" and count how many men come up before one fucking woman holy shit hahahaha 8/14/15  12:26AM. eee-in well may be if you typed the word 'actress"" you fuckong idiot"	__label__not_offensive
SAID SHE WANTS TO HEAR THE OCEAN TOLD HER I'D BRING BACK A SEASHELL mematic.net	__label__offensive
When u texted ur man 3 min ago and he still hasn't responded @daddyissues entube I'm single right now.	__label__offensive
"IN MY COUNTRY IF YOU ENTER THE WOMEN SECTION OF THE METRO YOU GET ARRESTED BUT WOMEN CAN FREELY ENTER THE ""MAN SECTION"" AND TAKE YOUR SEAT AND YOU HAVE TO STAND THEN."	__label__not_offensive
SILLY GIRL Art Base 3-6|Dec THATS NOT THE KITCHEN memecenter.com Mamelenler	__label__offensive
YOU MEAN TO TELL ME I HAVEN'T BEEN MAKING FRICATIVES?	__label__not_offensive
YOU TELL ME ...DADDIES LOVE BOOBIES TOO?	__label__offensive
SO YOU MEAN TO TELL ME THAT BOOBS ARE NOT JUST FOR MILK? Skeptical Baby	__label__not_offensive
WA Go THE ONLY THING YOU NEED IS AN UNSHAKEABLE BELIEF IN YOURSELF! What Wouluarvey Do?	__label__not_offensive
"THE APPJUICE ""I RESPECT YOU. YOU ARE AN EXCELLENT ATTORNEY AND A VALUABLE MEMBER OF THIS FIRM."" usa"	__label__offensive
"Keep calm and think ""What would Harvey Specter do?"" whisper"	__label__not_offensive
WORK UNTIL YOU NO LONGER HAVE TO INTRODUCE YOURSELF Pic COLLAGE	__label__not_offensive
Harvey Specter @ HarveyLLB SUITS is like Splitsvilla.	__label__offensive
HAPPY BIRTHDAY GURL! memegenerator.net	__label__offensive
DAMAGED PEOPLE ARE STRONG BECAUSE THEY KNOW HOW TO SURVIVE. INSTAGRAM WORDS2SUCCESS	__label__offensive
LOYALTY IS A TWO-WAY STREET. IF I'M ASKING FOR IT FROM YOU  THEN YOU'RE GETTING IT FROM ME.	__label__not_offensive
THIS IS HOW I FUCK THE SKY	__label__offensive
IT'S SIMPLE WE KILL SPIDER-MAN quickmeme.com	__label__offensive
SPIDER-MAN JUST WATCHED INFINITY WAR imgflip.com	__label__offensive
Oh god why did I order the vindaloo curry? MARVEL.COM	__label__offensive
STAND BACK proudly hosted on photobucket I'M GONNA TRY SCIENCE	__label__not_offensive
Rare image of united airlines staff training to re-accommodate a passenger Facebook.com/The NationOfDitkovich	__label__not_offensive
SO WHO IS GOING TO SPIDERMAN BLOW-UP SPIDERMAN?	__label__offensive
I'M NOT GONNA LIE KID THERE WAS NEVER ANY CANDY	__label__offensive
You've been hit by You've been struck by A smooth criminal Funny being.com	__label__offensive
I prefer the real aunt may. I said the real aunt may. Perfection.	__label__offensive
JUST ADD WATER! quickmeme.com	__label__not_offensive
HERE'S HOW DEADPOOL MADE HIS DREAM COME TRUE AAAARGH!!!	__label__offensive
THAT MOMENT WHEN SPIDER MAN SLEPT WITH IRON MAN Explain this before I end you	__label__not_offensive
For the last time Peter I'm not Hitler Stop asking for autographs	__label__offensive
THIS IS THE LAST TIME I DROP ACID WITH SALVADOR DALI.	__label__offensive
THATLL TEACH THOSE ORPHANS NOT TO FUCK WITH ME	__label__not_offensive
MY FAGGOT DETECTOR IS OFF THE CHARTS!	__label__not_offensive
YOU'RE NOT MY REAL DAD spiderman memes 60s spiderman memes  funny spiderman memes	__label__offensive
I LIKE SPORTS I COULD PLAY SOMETHING IN SPORTS quickmeme.com	__label__offensive
Just when I thought I ran out of insults USA MAX SCORE VAPEY MCDOUCHEFACE 16.400 DEDUCTIONS 1.400 2 OMEGA SCORE 15.000 Sports Memes no	__label__not_offensive
3 BALLS WITH ONE KICK  MUST BE A RECORD Trendingnuts.com	__label__offensive
MAKE FUN OF MY UNIBROW ONE MORE TIME! KENTUCKY SPORTS MEMES	__label__offensive
DAD. WHAT'S TAKING THE GAME WINNING SHOT? I DON'T KNOW SON. I'M LEBRON JAMES	__label__offensive
"CR7: ""THE GOD OF FOOTBALL SENT ME TO BE THE BEST!"" MESSI MESSI: ""I DONT REMEMBER SENDING Trendingnuts.com"	__label__offensive
EUROPE We have to cancel this match Snowing is too hard. FOUND AT VERYFUNNYPICS.EU Meanwhile in Russia	__label__offensive
YOUR KID IS THE BEST ON HIS LITTLE LEAGUE TEAM? TELL ME MORE ABOUT HIS FUTURE IN MLB. imgflip.com	__label__offensive
JUST HAD THE CRAZIEST DREAM CSN H MUUT FACEBOOK.COM/THEMLBNEMES dis THAT I ACTUALLY WENT TO AN ASTROS GAME	__label__offensive
You have to expect things of yourself before you can do them. - Michael Jordan BULLS	__label__not_offensive
Gate locking her out Grim Karen [adult swim] Let me in. I need to tell you its NOT GOING TO BE OKAYYYYYY [adult swim]	__label__not_offensive
Od winter book.com/NBAMCAMINE DON'T BRING A GIRL TO THE NBA PLAYOFFS SHE'LL GET BORED	__label__offensive
THAT MOMENT WHEN TOM JUST HAD ENOUGH OF JERRY'S CRAP imgflip.com	__label__offensive
When you get tired of going to work every day so you start hitting up the golf course looking for old rich men like	__label__offensive
"What if the ""10 Year Challenge"" was created by Zuckerberg to optimise the face recognition software"	__label__offensive
FBI: We need to start updating our facial recognition database Facebook: We could do a 10 year challenge and users will do it for you FBI:	__label__not_offensive
9 Year olds seeing others doing the 10 years challenge	__label__offensive
HOW TO BE A DESIRABLE MANIN: 2009. 2019	__label__offensive
IT Employees #10 YearsChallenge BULLA MEMES I.T MEMES 2009 2019	__label__not_offensive
"Donald J. Trump OrealDonald Trump ""We build too many walls and not enough bridges."" - Isaac Newton 4:11 PM Oct 7 2013 Twitter Web Client 79.8K Retweets 66.2K Likes Mod. this whole operation was your idea"	__label__offensive
When you are can't do the 10 year challenge cause you are a Pewdiepie subscriber Saved ourselves from some cringe if you ask me.	__label__not_offensive
"DEAR AVENGERS MOVIE CONSPIRACY THEORISTS... THE ""QUANTUM REALM"" DOESN'T WORK THAT WAY! NOW SHUT THE #@[% UP AND GO TO BED!"	__label__offensive
IG:@marvel_memes WHAT GIVES YOU THE RIGHT? WHAT'S THE DIFFERENCE BETWEEN YOU AND US? @marvel memes I GET TO BE IN THE AVENGERS	__label__offensive
yes i really love thor and loki	__label__offensive
Tony looks on in terror as Thanos unzips his pants  revealing two more Infinity Stones	__label__offensive
Tell Thanos I'm coming MARVEL STUDIOS AVENGERS 4 REVENGE OF THE WICK	__label__offensive
. - DC OR MARVEL? MEME MADE BY THE FB PG DC/MARVEL-COMICS/MOVIES I LOVE BOTH! I CAN'T CHOOSE AND I WONTI THATS WHAT I'M TALKING ABOUT! IT WAS A TRICK QUESTION! ~Agent Coulson	__label__offensive
I think I downloaded the wrong Avengers movie Dark Morbid AVENGERS INFINITY WAR	__label__not_offensive
"EVERY TIME I ALREADY KNOW A VERSE ""I UNDERSTOOD THAT REFERENCE"""	__label__offensive
YOU ARE BEAUTIFUL GO TO HELL YOU ARE REALLY POWERFUL GO TO HELL CAN YOU LEAD THE AVENGERS REALLY? GO TO HELL	__label__offensive
Were not in the Avengers Endgame Movie The Endgame	__label__not_offensive
PHO KING NOODLES? DO I LOOK LIKE I WANT PHO KING NOODLES? quickmeme.com	__label__not_offensive
I WANT ANSWERS	__label__not_offensive
WE CAN ONLY HAVE ONE DRUNK BABY MEME | YOU'RE GOING TO MAKE ONE OF THEM DISAPPEAR BEFORE MY NAP TIME 9GAG.COM/GAG/5186230	__label__not_offensive
YOU TELL THAT PENGUIN WITH THE BAD WEAVE KEEP MESSING WITH AYOOLA  AND THAT WEAVE WILL BE EATING PAVEMENT! quickmeme.com	__label__offensive
GIMME THAT CAPRI SUN BITCH IM THIRSTY quickmeme.com	__label__offensive
THAT AWKWARD MOMENT WHEN YOU REALIZE... YOUR OB'S BEEN SACKED MORE THAN THE NUMBER OF POINTS YOU'VE SCORED ALL PRESEASON	__label__offensive
Barry  I'm afraid we're going to have to make some serious changes around here.  Let's start with my diaper.	__label__not_offensive
LEAVE THE GUN TAKE THE CHEERIOS MC memecenter.com/godfather85	__label__offensive
"The Godfather"" AL Davis Raider Nation quotes ""Just Win Baby""&"" Commitment to Excellence "" is how we won our 3 SB's . So lets get this Win from the Texans & move on up to the next game.. Madd Maxx Graphixs~ #Onenation #Loyalty Crew #SBA4L"	__label__not_offensive
DAM READY FOR WORK Imgflip.com	__label__not_offensive
MOM SAID ALCOHOL IS THE ENEMY JESUS SAID LOVE THY ENEMY THE MATTER IS RESOLVED CrazyHyence.com	__label__offensive
THE ONLY B'WORD YOU SHOULD CALL A WOMAN IS BEAUTIFUL BITCHES LOVE BEING CALLED BEAUTIFUL memegenerator.com	__label__offensive
ANIMATED MEMES WAIT FOR IT...	__label__offensive
"Barney Stinson It's going to be Legen wait for it Dary"" -Whatever you do in this life  it's not legendary  unless your friends are there to see it. ~Barney Stinson Barney Stinson "" it's going to be Legen wait for it day"""	__label__not_offensive
WHAT DO YOU CALL A COW FALLING OFF A CLIFF? LEDGE-END _WAIT FOR IT DAIRY MEMES & FUNNY PICS FRABZ.COM	__label__offensive
HIMYM fact #7 scenesofhimym There are only 12 times during the series when Barney doesn't suit up. Did you know? #HIMYM. https://t.co/KWECEPESMs	__label__offensive
CHALLENGE ACCEPTED imgflip.com	__label__offensive
I TRIED TO BE FRIENDZONED	__label__offensive
ROBIN THICKE rcedes Ishio IS THE REAL BARNEY STINSON imgflip.com	__label__offensive
IDO RESEARCH BECAUSE I'M LEGEN...WAIT FOR IT....DARY imgflip.com	__label__not_offensive
THAT FACE YOUR FRIEND GIVES YOU WHEN YOUR CRUSH WALKS INTO THE ROOM.	__label__offensive
NIGHTMARES Are made of this.	__label__not_offensive
YOU LYING LET ME	__label__offensive
WHY HELLO THER memegenerator.net	__label__offensive
Ability When you can make three generations of people laugh their socks off	__label__offensive
Baby Mr. Bean Funny Picture	__label__offensive
WHICH SEAT CAN I TAKE? NOT THIS ONE	__label__offensive
THAT ONE MOMENT WHEN YOU FIND OUT WHATI MEAN memecrunch.com	__label__offensive
ONBAMemes AKERS a lakception.cow/4506 Kobe Mr. Bean Bryant! Credit: Basketball Pics	__label__offensive
MR BEAN AND DR. HOUSE Double the Epicness We Know Memes	__label__offensive
Mr. Bean Face Me Reinvented by SpikePheonix for iFunny :) ifunny.mobi	__label__not_offensive
YOUR FACE MemeCenter.com WHEN THERES A SUBSTITUTE IN MATH CLASS	__label__offensive
SAYS WILL WENDELL WON'T quickmeme.com	__label__not_offensive
Mr. Bean: NBA Edition! Credit - Alfred Justin Montoya	__label__offensive
Mr. Bean taught me one thing in life. Enjoy your own company instead of expecting someone else to make you happy.	__label__not_offensive
amycalvins These Pics Of Mr. Bean Photoshopped Into Pop Culture Moments Are Hysterical Trollery	__label__offensive
No matter how old I grow o _Dekh Bhai 'I will always enjoy watching Mr.Bean Double Tap if you've seen his show #AmazingComedian #SoTalented #inspiration. @ommy_007	__label__offensive
IDONTALWAYS PLAYTHE PIANO BUT WHEN IDOIES WITH AN UMBRELLA IRST.org Girls and entertainment	__label__not_offensive
Thanks for making our childhood awesome Mr. Bean.	__label__offensive
The new Mr Bean figure is pretty life like	__label__offensive
THE REAL MR. BEAN The real Mr. Bean	__label__not_offensive
@DCMARVEL_MEMES TAG A FRIEND SO THEY OPEN THEIR PHONE TO SEE THIS	__label__not_offensive
I STILL KNOW NOTHING! 2017	__label__offensive
"Create a hashtag for this... ""NO TIME TO EXPLAIN. GRAB ALL THE HELICHRYSUM YOU HAVE AND HOP IN THE CAR!!!"" ESSENTIALOILSTYLE.COM"	__label__offensive
YOU'RE THE BEST AROUND. NOTHING'S EVER GONNA KEEP YOU DOWN. Ralph Macchio	__label__offensive
WHAT OILS ARE GOOD POR CUTTING THAT POUL SMELL OF A BODY BURIBD IN YOUR BACK YARD? ASKING FOR A FRIEND. ESSENTIALOILSTYLE.COM	__label__not_offensive
If you're going on-and-on-and-on about your problems and I'm just nodding my head and not suggesting oils  You know I'm not listening  right?	__label__not_offensive
Tuesday is Mardi Gras Wednesday is Valentine's Friday is the Chinese New Year To those who celebrate in full force; I'll be waiting for you at the end of the week with a digestive blend. ESSENTIALOILSTYLE.COM	__label__offensive
MUST WATCH MOVIES OF 2017 ITI Chennai memes MAANAGARAM A HANDFUL OF DIVERSE CHARACTERS FIND THEMSELVES IN EXTRAORDINARY SITUATIONS THAT ARE INTERLINKED WITH ONE ANOTHER	__label__not_offensive
LESS MORE TALKING PLANNING SODA JUNK FOOD COMPLAINING WORRYING DOUBTING LAZING AROUND FROWNING INSECURITY WEAKNESS IGNORANCE HATE UNGRATEFULNESS LISTENING DOING TEA SALADS ENCOURAGING HOPING BELIEVING WORKING OUT SMILING TRUST CONFIDENCE UNDERSTANDING LOVE GRATITUDE An easy guide to making the rest of 2017 the best of 2017...	__label__offensive
When I have time is a fantasy. no one has time unless they make time. ARHtisticLicense.com	__label__not_offensive
"The starting point for every good idea is ""What if... "" ARHtistic License.com"	__label__not_offensive
