name voldemort who that memes maker com	__label__not_offensive
taken call liam neeson 0 0	__label__offensive
tom jerry realest beef time never said word sight	__label__offensive
priest throw holy water person possessed without consent think know i am going this essentialoilstyle com	__label__not_offensive
joins military gets kitchen duty quickmeme com	__label__not_offensive
wonder kill uncle free aunt eat makeameme org	__label__offensive
actual quality mr bean memes come soon 	__label__not_offensive
love really love me ! quickmeme com	__label__not_offensive
happy birthday dicky ! ! ! bad ! ! ! dave ! : - 	__label__offensive
leonardo dicaprio oscar memes hot right	__label__offensive
racist memes really getting me memegenerator net	__label__offensive
obama : check plbiden : actually we will take five milkshakes bill white house january 21st	__label__offensive
hillary lost legacy shit urs america	__label__offensive
life pretty simple sometimes need couple drops frankincense make everything better sometimes need couple billion dollars make everything better essentialoilstyle com	__label__offensive
adolf hitler bernie sanders believed state power would fix germany proposed gun control believes state power fix america promised political revolution proposes gun control promises political revolution calls socialist called socialist blamed jews germany problems blames rich america problems wanted heavily regulated economy wants heavily regulated economy	__label__not_offensive
245 liam asleep zayn shaved slit eyebrow harry official1dfacts tumblr	__label__offensive
happy birthday friend we arranged party pay bills also join old lady best friend meme crazy friends memes crazy happy 	__label__offensive
mean gas bills high quickmeme com	__label__not_offensive
wait ! forgot say911! pundit kitchen com	__label__offensive
call someone online russian bot one bats eye call someone npc everyone loses minds	__label__offensive
always win heres reward imgflip com	__label__offensive
smoke weed lose motivation become burnout never successful okay	__label__not_offensive
someone follows without invitation i am last person ever follow that use twitter 	__label__not_offensive
epic battle good evil briefly interrupted sound opener catbreedselector com catbreed selector catbreed select	__label__offensive
take pants suddenly whole room starts smelling like dumpster behind long john silvers : 	__label__offensive
sore whole day exercise me : ouch mymuscles me : again 	__label__offensive
fooled knighthood got i am still davos block	__label__offensive
i am busy speak playing pokemon donald trump imgflip com	__label__offensive
happy birthday liam ! thope chill today ! makeameme org	__label__not_offensive
best memes mark zuckerberg congress	__label__offensive
ask party facebook friends family leave hangin imgflip com	__label__offensive
bill bill bill facebook bill facebook bill post tomorrow monday weekend bill post vague status updates facebook attention seeker	__label__offensive
bill bill voted donald trump liked donald trump knew hillary would far far worse bill smart like bill 	__label__not_offensive
gene milder gene wilder	__label__offensive
happy birthday girlfriend ! ! memes com	__label__offensive
true fact 1219 marveltruefacts legion confirmed inits universe connected x - men film franchise think legion xmen gl	__label__not_offensive
trump kisses kim donald trump kim jong - un kiss umm kinda 	__label__not_offensive
soest never walk alone bill liverpool football club bill liverpool fan est : 1892 whenever liverpool wins doesnt say year bill knows gonna happen bill smart like bill belikebillfootball	__label__not_offensive
group friends always legendary	__label__not_offensive
entire social media timeline one giant leonardo dicaprio meme shitheadsteve screams internally inception	__label__offensive
portrait karl marx hanging x - men mansion like comment 078 james johns mutant power mass starvation like reply	__label__not_offensive
woahitsjuanito tumblr com keep calm stay legendary wait	__label__offensive
troll feminists memecenter com need feminism man told dont 	__label__offensive
bitch lasagna trash mammal follow replying aliahgeyes got whole class sick oldascreatures 4 : 49 dec 2018 retweets 449 likes 449	__label__not_offensive
this kill plz	__label__not_offensive
observe mark zuckerberg attempt suicide drinking water get mess know robots shortcircuit wet imgflip com	__label__offensive
start last man left off thomas edison visit : www cettechnology com memes quotes techsolmarketing com free use without modification	__label__not_offensive
big man suit armor take away you tark naked	__label__offensive
single deeply part identity truly know wtf i would boyfriend walk it often need fed i am ready	__label__not_offensive
hey beautiful smile don t feel like	__label__offensive
really bitch memegenerator net	__label__not_offensive
noticed toilet paper gone taking dump know memes	__label__not_offensive
snake bit	__label__not_offensive
need feminism pretending care gets laid seriously else going happen	__label__offensive
chuck norris need hammer	__label__offensive
ditf fans seeing hiro ichigo pilot together episode ditf fans see hiro becomea blue onlin episode imgflip com	__label__offensive
men could get pregnant abortion clinics would like starbucks would two every block four every airport	__label__not_offensive
laughing cuz that funny memegenerator net	__label__offensive
happier quickmeme com	__label__not_offensive
trying understand chronology x - men films i am talk aveng fuck	__label__offensive
got perp says he gonna play texas wakatopopcountry com fiddle band	__label__offensive
barney stinson born himym https : t co htqyblerh	__label__not_offensive
please thank tonsofthanks com meme	__label__not_offensive
technology classroom much learningtor net	__label__offensive
taking notes 21st century	__label__offensive
rahul gandhi yet start career yrs retired successfully yrs http : chuornot netcurate com stories rahul - gandhi - meme	__label__not_offensive
kim jong say father died looks like korea looks like korea over 	__label__offensive
original distracted boyfriend meme template charlie chaplin distracted boyfriend meme template half naked girls get thousands updots many farblos guy 	__label__offensive
wish your man me 	__label__offensive
type send nudes auto corrects send nukes vladimir putin memes totally see sayinglmages com	__label__not_offensive
watch friends ! imgflip com	__label__offensive
man man fake genius real genius anda anda fake president real president questions 	__label__not_offensive
grow i am going kill batman made imagur	__label__offensive
hurriedly participated 10yearschallenge without checking photo sub expire 	__label__offensive
fuck year challenge who brave enough todo this ! 093 next challenge current who bad 	__label__not_offensive
aunt may years ago aunt may today free toast e - z loans boredpanda com	__label__offensive
facebook training face recognition year challenge let get facts viral challenge amanda blain amanda lain	__label__offensive
paul lieberstein paullieberstein year challenge everyone jealous masipopal steve carell stevecarell macklemore actually shopped thrift stores imao 1 16 19 2 : 53 credits masipopal	__label__not_offensive
world leader 10 - year challenge 2009 2019 even world leader participating 10 - year challenge ! 	__label__offensive
magic hair magic hands 	__label__not_offensive
realising marvel released avengers : endgame avengers super fan seeing film	__label__offensive
skipped marvel movies facebook com kaatupoochi007 directly watching avengers endgame	__label__offensive
cinema waiting infinity war start : cinema infinity war : 	__label__offensive
long staring window 2016 2018	__label__not_offensive
avengers call ourselves we are sort like team earth mightiest heroes type thing 	__label__offensive
god	__label__offensive
peter i am like din chris everything but dc tom yeah he ! i am thought chris chris what 	__label__not_offensive
there one told nap he will napping fishes tonight babe	__label__not_offensive
mexican climbed wall send back mexico ! imgflip com	__label__offensive
bride got cold feet shit going whether like aanm 	__label__not_offensive
son bitch took whats mine bring nose back memebase com	__label__offensive
british troops attempt attack fort duquesne french indian war 1758 colorized 	__label__offensive
one hides	__label__offensive
baby godfather stole blankie want dead naptime quickmeme com	__label__not_offensive
godfather got baby daughter brass knuckles	__label__not_offensive
kids much energy siphon parents like little gasoline thieves 	__label__offensive
ladies gentlemen time suit tereyenerator net	__label__not_offensive
cheerleader effect cheerleader effect group women seem hot group take woman individually sled dogs 	__label__not_offensive
firewalk charity challenge accepted ! memegenerator net	__label__not_offensive
i am mess even like me almost messed alam find barney himym https : t co fosho9w9000o	__label__offensive
times barney stinson total romantic himym 	__label__not_offensive
let day without talking day good loved side barney himym	__label__offensive
face make mouth open somebody sneezed imgflip com	__label__offensive
stages taking exam unprepared denial frustration cheating attempt do random stuff answer might come me stage desperation depression regret starecat com	__label__not_offensive
mr bean taught me enjoy company	__label__not_offensive
8crap mr bean really bean he actor 8crap mr bean bean via 8crap	__label__offensive
absurd : lavar boasts makes funnier faces mr bean kicker first jordan gronk this ! 	__label__not_offensive
know mean	__label__offensive
exam marks grades alcohol myths girls world facebook com completegate completegate com	__label__offensive
looking mr bean avatar forum use expect this 	__label__offensive
bean teddy far better relationship rvcj wwwrvci com today couples bean - teddy ! 	__label__not_offensive
mr bean memes always good investment matter what 	__label__offensive
mr bean family expectation reality	__label__not_offensive
therefore leaving immediately nepal intend live goat 	__label__offensive
think drives	__label__offensive
moment realize even mr bean girlfriend still single	__label__offensive
bean person interest fbi investigation trump russia accused sending coded messages via face expressions body language	__label__not_offensive
mom feels child he able count till three	__label__offensive
one door closes another bottle favorite emotional blend opens essentialoilstyle com	__label__not_offensive
told everybody relationship happy everybody single miserable 	__label__offensive
sprinkle wrong answer test teacher know ai not cheat 	__label__not_offensive
fellow procrastinators : seriously need get peppermint grapefruit on ! many holiday errands still need tomorrow essential oilstyle com	__label__offensive
steak rare made pokemon card	__label__not_offensive
 record scratch freeze frame pope : yep that me probably wondering ended situation 	__label__not_offensive
listen bad music 	__label__not_offensive
cats fed dont listen bullshit	__label__offensive
luke : happens press button old ben : know try out 	__label__not_offensive
no2 best 2018 august paw patrol writers defend episode german shepherd cop shoots unarmed black lab times back best 2018 augest	__label__offensive
cell phone sight living moment absolutely beautiful wish could back	__label__offensive
rowan scottpilgrimm follow i am obsessed memes indie alternative wlwa ppl afraid growing lorde ppl hate hometown indie alternative mlm alady 2 : 11 aug 2018	__label__offensive
angel gabriel appeared mary said made fumatic purge xenos ! 	__label__offensive
what is mom name aquamartha welcome justice league meme friday : best 2018	__label__not_offensive
bill bill girlfriend bill post photos day girlfriend bill likes keep things private that be bill smart be like bill	__label__offensive
bill www nishantdas net bill loves comment every sneeze peacefuls bill avoids commenting pathankot runs away asked malda bill smart like bill 	__label__offensive
best thing dating bills fan know ai not looking ring	__label__offensive
look photo play goodbye horses garvey remixes do it 	__label__offensive
peoplescube com clintons sleeping together	__label__offensive
t - dog wears flat bill snapback wallet chain says things like hoes trippin yo party fire t - dog signed record deal country singer t - dog fans idiots like t - dog fans farcethemusic com	__label__offensive
got skills pay bills imgflip com	__label__not_offensive
bill bill waiting car girlfriend bill get angry knows girlfriend getting pretty him bill loves her like bill 	__label__offensive
bill bill use word bae bill smart like bill 	__label__offensive
dollar dollar ihos834 761 m58347624 bill y all icanhascheezburger com	__label__offensive
bill internet bill sees something offends him bill moves on bill smart like bill 	__label__offensive
buffalo bills fans nfl memes loudest losers world imgflip com	__label__not_offensive
bill refuses left dead daylight	__label__offensive
bill bill bought new hat bill used apple pay hold line bill trendsetter like bill	__label__not_offensive
hide kids hide wife cuz 2014 - 2015 bills coming	__label__not_offensive
bill bill facebook bill repost stupid memes himself 	__label__offensive
bill b il doesnt like bill memes - 1 - 12 bilis smart cand calm belike bill gip com memes com	__label__offensive
bill bill use word bae bill smart like bill 	__label__not_offensive
big bang theory memes bad feel bad menegerleratur net	__label__offensive
love air wrong nitrogen oxygen carbon dioxide air imgflip com	__label__not_offensive
baby i will treat like homework i will slam table night long quickmeme com	__label__offensive
trying scare me cause youre succeeding gifsec com	__label__offensive
31 - 45 tried including taylor swift mix 16 thebigbang theory 8x13 sal k31 2705< turns love we are page sheldon tbbt thebigbangtheory	__label__offensive
hungary may czech fridge russian kitchen turkey covered layer greece eww norway eat smjbuzz com big bang theory	__label__not_offensive
fifty shades sheldon 2012	__label__not_offensive
two reasons watch big bang theory	__label__offensive
someone feeds	__label__offensive
keep looking cute they will surely blame dog	__label__offensive
human that a tuna sandwich got	__label__not_offensive
day 11 : dog still thinks i am fur	__label__offensive
sad make better ! 	__label__offensive
cat memes meow meme machine	__label__not_offensive
everything going according plan quickmeme com	__label__offensive
invisible bike	__label__offensive
way pet sucks	__label__not_offensive
still love tomorrow tomorrow even like today	__label__offensive
cheezburger cat memes 2008 : hee2eurger com walking cat memes 2018 : 	__label__offensive
igot new toy ! funnycat memes xyz play exactly one day want new one 	__label__not_offensive
johnson heard spent day looking birds outside window good work johnson memegenerator net	__label__offensive
sorry must always take bath weird cat 	__label__offensive
i am adult like adult cat like someone probably take care also sorta make own 	__label__offensive
 interesting new cat food	__label__not_offensive
look happy stop	__label__offensive
follow mouse ! 	__label__offensive
came i saw complained 	__label__not_offensive
want piece serious 	__label__offensive
ami better grumpy cat grumpy cat feelings	__label__offensive
cat missing several hours untill got call neighbor 	__label__not_offensive
keyboard : exists cat : free real estate	__label__not_offensive
starts talkin bout we lot tryna figure started taking french	__label__offensive
want sleep keyboard one using computer awesome stuff thumbpress com	__label__offensive
aypo3 could indians hit anymore home runs today imgflip com	__label__offensive
gulp ! chandler : i am great advice interest sarcastic comment warner bros television brightside me	__label__offensive
january know what gonna happy year gonna make happy nilanjana ghosh march exhaustina waiting death	__label__not_offensive
must like crippled fear self - loathing	__label__offensive
omg - friends - blog last name omg friend - blog central perk 	__label__not_offensive
google number one searched item bing 28th straight month memecenter com guide others treasure cannot possess	__label__offensive
12 : 08 1 38000 hate chandler bing job none knows still series ended monica chan wanted live sub arbs never see	__label__offensive
chuck passed kidney stones last week six infinity stones imgflip com	__label__not_offensive
threw grenade killed people exploded	__label__not_offensive
stares solar eclipse sun goes blind	__label__offensive
chuck norris doesnt smoke cigars smokes smoke grenades memecrunch com	__label__not_offensive
chuck norris built printer never jammed 	__label__not_offensive
chuck norris fact day chuck norris ate rubix cube shit solved	__label__offensive
ask google google asks him ! chuck empire40000 com	__label__not_offensive
chuck norris died years ago death built courage tell yet 	__label__offensive
i am sorry wrong number no picked wrong phone imgflip com	__label__not_offensive
chuck norris threw grenade killed people exploded marsden martial arts	__label__offensive
chuck norris darth vader father n000000000000	__label__not_offensive
chuck norris steps lego memecenter com memecenter	__label__offensive
chuck norris never heard her memeful com	__label__offensive
ahead buy house chuck norris quickmeme com	__label__not_offensive
youre girl starts playing take home country roads surprise sure welcome one makeameme org	__label__offensive
parents say you : parents : band	__label__offensive
someone want lose fingers priceless craver touches hair	__label__not_offensive
christmas morning brad harris dad says cattle need fed open presents 	__label__not_offensive
kill makes stronger except country girls country girls kill you 	__label__offensive
quiet hillary h q right liberty memes hear email deleted	__label__not_offensive
country girl funkye dha co shook	__label__offensive
country friend trouble adjusting city life memedroid	__label__offensive
sings country music wearing shirt gets country flag wrong quickmeme com	__label__offensive
okay like country music everyone good taste country rebel	__label__offensive
look marge i am black country 	__label__offensive
given love love given	__label__offensive
me : hate country music dolly parton : jolene me : 	__label__not_offensive
acowboy	__label__not_offensive
know play country western music backwards pickup start dog come back sweetheart love again ! 	__label__offensive
russians poles hating ukrainians russians ukrainians hating poles ukrainians poles hating russians starecat com	__label__offensive
there country music here shitheadsteve	__label__offensive
cold beerem jeans small town beer beei trucks girl truck beer hey girl trucks	__label__offensive
deadpool memes cosplayers try hard quirky funny memegenerator net	__label__not_offensive
idontget guys said wanted see cock	__label__not_offensive
love posters look really intense there deadpool new class super hero divided fall almand littl tak 2016 deadpool batman superman things marvel x - men apocalypse via 9gag com	__label__not_offensive
first time deadpool met spider - man told spider - man future 	__label__offensive
congratulations ! d pooly time chimichangas generator net	__label__offensive
mortician i would tie shoelaces dead together way ever zombie apocalypse would hilarious	__label__offensive
 marvelousfacts deadpool actually like chimichangas likes saying word funny deadpool fact	__label__offensive
look see text realize actually trapped inside meme ca not nerds give break 	__label__not_offensive
hate captain america mean love captain america i am canadian apitnobaka : deadpool knows whats	__label__offensive
hey guys look i am captain america	__label__offensive
language ! really blerd vision did become best friends ! later	__label__offensive
outlift someone bigger	__label__not_offensive
wanna know cares nobody imgflip com	__label__not_offensive
use dicaprio memes alan wng memegenerator net	__label__not_offensive
started bottom titanic 1997 great gatsby 2013 	__label__not_offensive
celebrities leonardo dicaprio star h h holmes new serial killer series message american press please stop using pictures talking leo know hard separate research audition show turned little guess went next best actor 	__label__offensive
here memes make smile	__label__offensive
get nominated first annual meme awards shitposter year awards we are leonardo dicaprio meme pages 	__label__not_offensive
makes front page leonardo dicaprio meme drops wine glass imgp com	__label__offensive
took things mean maybe fought harder	__label__offensive
master given leo oscar leo free	__label__offensive
leonardo dicaprio almost died skydiving accident yourcelebrityfacts tumblr com would terrible	__label__offensive
leonardo dicaprio age age looks like someone taste morgan freeman fountain youth 	__label__not_offensive
leonardo dicaprio bald basically jack nicholson never seen anything true everything coming full circle fam	__label__offensive
leo oscar winning speech years 	__label__not_offensive
leonardo dicaprio winning best actor oscars 2016	__label__not_offensive
leonardo dicaprio win oscar acting like winning oscar bother	__label__not_offensive
try leave work little early	__label__offensive
meme within meme memeception staring leonardo dicaprio	__label__not_offensive
 shotongoal247 : leonardo dicaprio psgliv tonight he still best actor stadium https : t co bq7zmosptj	__label__not_offensive
struggle struggle struggle struga every next level life demand different you - leonardo dicaprio 100	__label__not_offensive
fact 388 leonardo dicaprio accidentally cut hand table scene django unchained remained character scene ended recieved applause crew	__label__offensive
know psy seem familiar wht look like memecenter com memecenter	__label__offensive
follow andrew abernathy follow ajabernathy could turned tables ! shutterstock nutterstock shuesick shutterstock halos shutterstock 2 : 35 nov 2017	__label__offensive
nelson krang nelson follow right lady nice butt 9 : 41 aug 2017 505 retweets 592 likes	__label__offensive
jack black gt; distracted boyfriend	__label__not_offensive
sitting bed absolutely nothing feeling worse every single passing second writing art things love	__label__not_offensive
wedding day get distracted another man gainz ! ! ! bodybuilding humour new distracted boyfriend meme	__label__offensive
hey man seen hat memegenerator net	__label__offensive
mean tell drink belongs someone else him 	__label__offensive
part oftwant grandmas ive gone understand 	__label__offensive
said think enough told woman stop good ready imgilip com	__label__offensive
mrw boss asks i am drunk	__label__not_offensive
misfits	__label__offensive
doi make horny baby doi oh behave	__label__offensive
memecenter com dr evil making penis shaped rocket ships holding world one billions dollars since back day 	__label__not_offensive
denton fracking ban frackfeed com one million dollars	__label__not_offensive
i am gonna build wall put freakin laser beams hilariousdepot pointe try comment dr evil letter letter uninterrupted impossible first one gets tagged meme	__label__offensive
one hundred million dollars aussiememes com au	__label__not_offensive
restoring 4014 million dollars imgflip com	__label__offensive
feels polite inside acts impolite quickmeme com	__label__offensive
woman also get equal responsibilities feminist fuck said	__label__offensive
hey girl keep laws body keep hands it 	__label__offensive
thinking slapping feminist 	__label__offensive
posts anti - feminist memes day women ever going touch memegenerator net	__label__offensive
collect purple	__label__offensive
ask feminist make sandwich get offended yells thinking capable making sandwich	__label__offensive
yiu ca not judge female driver proud that ! sexist bastard ! really wanna honey 	__label__not_offensive
white feminism racist white call feminist need watch this 	__label__offensive
violence men : girl violence women : stop cycle violence	__label__offensive
life goals sexism patriarchy unsafe roads trump fuzia life goals	__label__offensive
like women like like coffee strong given proper credit contributions home workplace memecrunch co	__label__offensive
hard swallow pills women actually like nice guys probably nice guy think	__label__offensive
guy gives compliment asks talk real quick say no thank say great day miss boredpanda com	__label__not_offensive
sexuality shown effort boost capitalism either satisfaction goods consumer value follows cis white male needs immediately demonized bunnymemes britney spears	__label__not_offensive
feminist actually misogynist trying make women look stupid quickmeme com	__label__offensive
pus make make rule delusional hell really believe crap ! 	__label__offensive
hey girl god called ministry imgflip com	__label__not_offensive
hey girl apply feminist epistemology story arc skyler white sort becomes hero	__label__offensive
asim busara as m busara generation becoming busy trying prove women men women losing uniqueness women created everything man do women created everything man ca not do look lady man brain memecenter com magnabad delta - thrillar	__label__not_offensive
said fight like girl took compliment	__label__offensive
ca not handle meme admin deserve curated contrived internet persona	__label__offensive
shout feminist meme admins ensuring ill never able comfortably talk women public ever veganoverlord snapchat : dankmemesgang	__label__offensive
want men looking maybe cover	__label__offensive
try pet dog walks away : congratulations loved please resist 	__label__not_offensive
feminism definition belief men women equal rights united nations webcast : wenn made imgur	__label__offensive
random person makes friends reference friendss 	__label__not_offensive
see friend hanging person complaining day fake	__label__offensive
late work week know means me : stupid	__label__offensive
want cheese sammich imgflip com	__label__not_offensive
mother used say way man heart stomach lovely woman useless surgeon 	__label__offensive
friend texts i am here walk outside they are gariksuharik	__label__not_offensive
atmom : whyare always in room looks like friends friends make easier discover new items collect free find friends make memet	__label__not_offensive
friend think something dirty way 	__label__offensive
friend via 9gag com say thing time memeful com	__label__not_offensive
moment when realize need new friends quickmeme com	__label__offensive
cousins awesome well mine are ca not speak someecards	__label__not_offensive
picture cousins think going family wedding picture actually do 	__label__offensive
see favorite cousin pull thanksgiving	__label__not_offensive
show attitude blocklist bigger friendlist	__label__not_offensive
i am pretty little girl	__label__offensive
rach please tell we are getting rid her joey ca not that ! come on ! last night finishing pizza said : ooh ooh ooh moment lips forever lips ! need kind talk house ! 	__label__offensive
i am glad share sense humor understanding i am slightly funnier someecards	__label__not_offensive
said could anything became prime minister memebase com	__label__not_offensive
take left turn said free easy said	__label__offensive
friends deciding entertain power funky music board games movies memes video games minecraft herobrine sightings irl	__label__offensive
friends tells friends memes never take believe evolution irl	__label__offensive
one ever asked memegenerator net	__label__not_offensive
gene wilder ill fuckin wreck icanarscheezburger com	__label__offensive
called mutant dna gene wilder via thetoddwilliams	__label__offensive
gene wilder officalgene information lead hillary clinton arrest 8 28 16 6 : 50 785 retweets 432 likes	__label__offensive
screenshot convo send back person	__label__offensive
oh think willy wonka condescending jelly baby www dorktower com	__label__not_offensive
put candle back 	__label__offensive
dog tag necklace tell experience armed forces	__label__offensive
amazing person love you 	__label__not_offensive
moment realize need	__label__offensive
girlfriend treats like god sheignores needs something internet scavengers ph3lwab com	__label__not_offensive
ai not sunshine gone ai not borderline psychotic emotional outbursts either memes com	__label__offensive
 if jesus girlfriend find funny died days must look stupid huh poslo com internet scavengers	__label__not_offensive
cute things call girlfriend : sugar honey magdonals lady uhhhhhhhbten percent luck 1 2 butter twenty percent skill fifteen percent concentrated power preheat 375 	__label__offensive
fucking love girlfriend ! ! memegenerator net	__label__not_offensive
dear lord baby jesus thank smokin hot girlfriend vans memegenerator net	__label__offensive
girlfriend told bought one stupid gift would burn it bought candle modern problems require modern solutions	__label__offensive
know anything abouta movie want see still makes effort relevant quickmeme com	__label__offensive
boyfriend says excuse girl club who she awesome pictures themetapicture com	__label__not_offensive
asks spend time girlfriend think need space fumybeing com	__label__offensive
hates spend time playing video games ignore buys bunch co - op games play together memecenter com mamecenter com	__label__offensive
crazy ex - girlfriend got arrested today good day makeameme org	__label__not_offensive
real boyfriend always scared lose girlfriend	__label__offensive
someone asks i am still single know ! thought pretty awesome made imgur	__label__offensive
didnt answer calls got worried know memes	__label__offensive
him : heard died trying jump grand canyon me : ca not neither could	__label__offensive
act friendly one time ima make fucking scene crazy girlfriends	__label__offensive
toxic girlfriend	__label__not_offensive
another girl liked status blocked diylol com	__label__not_offensive
ask day tells genuinely enjoy love	__label__offensive
girlfriend watched every harry potter movie back back luckily one facing corvus	__label__not_offensive
got married overly attached girlfriend	__label__offensive
looked drawers saw lot panties there pervert rofleo	__label__not_offensive
worry honey made sure bitch would never said	__label__offensive
tell everyone story fell love girl looking like	__label__not_offensive
try kiss latina girlfriend sc : blsnapz latino	__label__not_offensive
thing even possible yes	__label__not_offensive
eorgiso guy threw shoe me 	__label__offensive
defend ronaldo giving less space possible letting shoot right messi praying jeep giorgio chiellini https : t co wdddfsmlnh	__label__offensive
hug kiss pet squeeze spank he bad call giorgio memecenter com memetenter	__label__not_offensive
giorgio tsoukalos via 9gag com even new usmall final form	__label__offensive
what is case mulder aliens history com	__label__offensive
ask allow fix fuckup ask respect offer friendship even think call sensei 	__label__not_offensive
give friend chocolate milk lunch puts cheeto look massacred boy notes	__label__offensive
tell count see sesame street days numbered memecenter com memecenter	__label__offensive
put fat bastard hit list pleasure	__label__not_offensive
mom said guys find game that three players 	__label__not_offensive
remember nephew people run packs feel safe alone run alone feel safe packs - godfather	__label__offensive
using overused animation formats using unexplored the godfather format format ca not refuse	__label__not_offensive
yiu perfect	__label__offensive
bronn he promised castle : 	__label__offensive
brace ramadan coming imgp com	__label__offensive
finally drop toxic girl life start glowing pmslweb com internet scavengers	__label__offensive
facebook com s ra - all woman jon snow bends knee imgflip com	__label__not_offensive
shall begin one half episode later losing	__label__offensive
guy told worry	__label__not_offensive
overhear rumors 8th season got may delayed 2019 give something rain let die	__label__not_offensive
woman used thing rides town put brothel betray husband	__label__not_offensive
feels bored ruins everything everyone quickmeme com	__label__offensive
died end	__label__offensive
game thrones season spoilers : bran stark night king here proof proof need massive nose	__label__not_offensive
jon snow discovers the dirty nerdy ie true targaryen	__label__offensive
uncle dad dad uncle camelia that cute 	__label__not_offensive
two types people world like tyrion watch game thrones	__label__not_offensive
got memes	__label__offensive
feel looking someone pen nurse extra pen nursing ati	__label__offensive
heard party died left	__label__offensive
thought told you world tanks quiche lorraine ! ! lorraine40t memetuc net	__label__not_offensive
 it hard killing off - so many characters adorable	__label__not_offensive
face someone tells dont time watch got	__label__offensive
show date extensive meme collection fucking big 	__label__not_offensive
broken hearts westeros	__label__offensive
moment realize pope francis high sparrow	__label__not_offensive
dany : refused bend knee sam : brother let home dany : boredpanda com	__label__offensive
you : switches private browsing bran stark : 	__label__offensive
day start new job trialby meme day quit mgflip com	__label__not_offensive
time igi memesofgameofthrones hated characters	__label__offensive
surprise ! 	__label__offensive
we are gonna build wall around wildlings murderers rapist assume good people make nights watch great	__label__not_offensive
lived bitch 	__label__not_offensive
got dude quickmeme com	__label__offensive
makes harry potter memes none funny quickmeme com	__label__offensive
best entertainer harry potter comic memes memes professionals	__label__offensive
master gave dobby glock	__label__offensive
yay talking gbm ! second request ! quickmeme com	__label__offensive
arry hpotter computer harry love good harry potter meme just not best 	__label__not_offensive
episkeyfirewhiskey tumblr com dracosredemption : girl next crabbe looks like crabbe wig on 	__label__offensive
put muggles outside fence 00 got vote	__label__offensive
party hard	__label__not_offensive
mother eyes	__label__offensive
expelliarmus keeps expecto patronuming	__label__offensive
friend : hey copy music theory homework me : change bit obvious copied friend : 	__label__offensive
cedric diggory death tragic accident ! sounds like birth ! 	__label__offensive
so lie yup	__label__offensive
liked basilisk slotherin underground roonil wazlib	__label__offensive
hear someone insulting harry potter : say face limp noodle ! 	__label__not_offensive
no ! come back ! dont twilight ! know memes	__label__offensive
know voldemort titanic roflraz21 com	__label__not_offensive
hard killing many characters adorable martin	__label__offensive
accept mistake please tell anyone happy - wishes net	__label__not_offensive
started bottom i am 	__label__offensive
hogwarts home ! are reading harry potter again 	__label__not_offensive
white house staff reaction trump first visit looks like voldemort showed battle hogwarts	__label__offensive
neville longbottom : master puberty spell	__label__not_offensive
unlucky here know exactly countercurse could spared her bitch please 	__label__not_offensive
family feud us answers left steve harvey speechless ! 	__label__offensive
psych yhe father maury maury sobasicicanteven mr mun	__label__offensive
i have watched walking dead enough know really prepare survival take half everybodys shit	__label__not_offensive
thought harvey price dumb met kieran memegenerator net	__label__not_offensive
drgraylang steve harvey steve harvey whoever keeps texting	__label__not_offensive
gun control cuba universal health care cuba want come here - paul harvey	__label__offensive
made mistake medals chewbacca	__label__not_offensive
friends roasting low alcohol tolerance remember gotta pay get drunk	__label__not_offensive
called tavis smiley cornell west uncle toms i am insecure biggest coon hollywood zipmeme	__label__offensive
getting home working 49 5 hour shift working hurricane harvey	__label__not_offensive
harvey irma married years marvel storms bearing names cute ca not tell	__label__not_offensive
hurricane harvey	__label__not_offensive
happy friday ! wait sorry monday 	__label__offensive
i am steve harvey watching cartoon network ! domy drama disney channel lmao incorrect ! clearly that nickelodeon	__label__not_offensive
jesus fed needy receiving massive public shaming twitter 	__label__offensive
steve harvey without facial hair looks like mask	__label__not_offensive
one job universe 2018 elminination card show pinals 2nd runner usa 1st runner colombia 161 runner miss universe 2015 philippines	__label__offensive
happy friday ! wait sorry monday	__label__offensive
said demode iowa colombia ! 	__label__offensive
steve harvey host oscars vagas com meheful coh maybe leonardo dicaprio win one 9gag 9gag 22h steve harvey mistakenly announced miss colombia winner miss universe 9gag com gag a0p9pvn re 35000 5 6000	__label__not_offensive
depression trying make end 2018	__label__offensive
joker evil scheme yetb memecenter com huko make love huk osh hards fifty shades gray hulk fucked fanfics 	__label__offensive
told hillary course i will stay faithful prison imgflip com	__label__offensive
i am saying secretary state illegal imgflip com	__label__offensive
sure dirty idiots dead people still vote her journelofamadman com shre it ! 	__label__not_offensive
hello fellow caterpillars ! make america great teach make dank memes ! 	__label__offensive
mexican word day : tenacho hillary clinton nacho president	__label__offensive
 pragmaticpolitics soundscience look get watch democrats bitch moan dnc media collaborating hillary laughed said would happen like ron paul 2012 	__label__not_offensive
46 467 huge ! leaked : hillary tru share 11 : 08 www tdnewswire com newswire hillary clinton suffers doctors described type lieabetes type one lieabetes chronic disease kept control duct tape help hillary debate 	__label__offensive
want someone look way bill hillary look balloons 	__label__offensive
323 million people and bring	__label__offensive
fuck hillary and broomstick rode tcc	__label__not_offensive
voting hillary 2016 raise handd use slap yourself idiot 	__label__offensive
new health care plan : dixon diaz university hospital stay alive till election day	__label__not_offensive
brick every lie hillary told could build two walls absolutely ! 	__label__offensive
presidential alert forgot crooked hillary memeshappen	__label__not_offensive
tide terror that sweeping nation theshining xrated	__label__offensive
usa finally gets female presidential nominee via 9gag com hillary clinton memeful com	__label__offensive
ceilings sky limit hillary	__label__offensive
bill google says question asked search engine whether hillary prosecuted think imgflip com	__label__not_offensive
hitler murder time lord regenerated body june 1946 queens newyork city imgflip com	__label__not_offensive
donald trump hitler hitler actually knew doing trump like magic ball terrible things it imgflip com	__label__offensive
volkswagen cars produce gaz expected via 9gas com ach ! ! that car	__label__offensive
anyone seen gary gary tall	__label__not_offensive
life like belgium times march	__label__not_offensive
nazi coming jew memegenerator net	__label__offensive
wikileaks reveals wwii actually funded agent hitler fbi 	__label__offensive
least work group project teacher gives credit barely 56 - 62 million 49 - 78 million million	__label__offensive
would win german artist little artistic talent 000 000 jews	__label__offensive
hipster hitler iphone per cool hitler taking tell it ! iphone days quickmeme com	__label__not_offensive
going flip investment would double ! 	__label__not_offensive
hipster hitler vaped even cool makeameme org	__label__offensive
man refusing stand fascists taken germany starecat com	__label__offensive
fact : adolf hitler time magazine man year 1938 moral story : mainstream media always reliable	__label__offensive
rollin homies	__label__not_offensive
hitler poses japanese delegation signing tripartite pact 27september 1940	__label__offensive
toy happy meal	__label__not_offensive
hits blunt do not attack whole europe time	__label__offensive
working kind horrible jobs deserve better jobs higher pay jews settle scraps care adolf hitler	__label__offensive
seen kyle he tall	__label__not_offensive
russian prisoner forced read nazi propaganda salute f hrer chance eat 1943 colorized 	__label__offensive
technology elon musk offers buy revive adolf hitler model gonna great ! 	__label__not_offensive
last character asshole trialbymeme playing hitler refreshing change pace - - greyjoy	__label__not_offensive
page gets deleted hitler meme still funny worth	__label__offensive
reincarnation hitler would win entire internet https : www battleforthenet com	__label__offensive
whoever came phrase the freaks come night clearly never walmart day 	__label__offensive
stop changing profile pics gomissing find look like beyonce facebook chewbacca person imgflip com	__label__offensive
dentist told need crown like know right 	__label__offensive
know didyouknowblog com jim carrey never heard doctor offered role 8th doctor declined thought fans would outraged part played fan show photo credit : psu edu didyouknowblog com doesnt sound true would make weird thats saying soemthing	__label__offensive
face wheni create new meme photo jim carrey everyday imgflip com	__label__not_offensive
hi i am looking gta single player dlc info and clean pair shorts imgflip com	__label__offensive
jim carrey calls brett kavanaugh an entitled little s tunderstand jim feeling kavanaugh girlfriend committed suicide accusing infected stds dumping her wait jim carrey oops gc 	__label__offensive
lebron looking like jim carrey the mask as www hiphopmeasure com www hiphopmeasure com	__label__not_offensive
jim carrey today irl	__label__offensive
player picks character fighting game	__label__not_offensive
serious feds keeping pot schedule drug imgflip com	__label__offensive
christmas serious memegenerator net	__label__offensive
funny anymore real candidates imgflip com	__label__not_offensive
donald trump president ! killing joke imgflip com	__label__offensive
i will harley quinn joker robin starfire icanhascherzburgerloh	__label__offensive
joker meme say nobody bats eye nobody bats eye someone claims nobody panics everyone loses minds ! quickmeme com	__label__not_offensive
joker done fucked wrong family	__label__not_offensive
simone giertz thats girl imgflip com	__label__offensive
smileus phra let puta smile face justicc icague memes joker always knew make people smile green arrow sorry posted much lately away vacation 	__label__offensive
uses meme correctly one bats eye uses different image joker everyone loses minds	__label__not_offensive
moment find joker robin went high school together mother god right ! ! crispy	__label__offensive
batman locks away one see him real criminal here 	__label__not_offensive
joker called wants grin back ! 	__label__offensive
wake joker facebook officialmvdc whats first thing do andy	__label__not_offensive
trump respect authoriti imgflip com	__label__offensive
alert : kim jong - un slathered nukes bbq sauce threatening send world flavortown adam the creator p78 - 075	__label__offensive
rock ! let see hilton build something better room imgflip com	__label__offensive
world really run dennis rodman 	__label__offensive
eat it please sir no 	__label__offensive
bbq sold out ! barely noon ! 	__label__offensive
respect authoritahi	__label__offensive
select deep pan classic crust know memes	__label__not_offensive
kim jong un dank meme storage facility could pick one place live 	__label__offensive
kim jong - un threatens blow los angeles away fresh approach bass guitar full story : thehardtimes net the dprk hesitate put foot monitor destroy los angeles crowds advanced harmonic techniques 	__label__offensive
 logan paul talked kim jong good now logang suscraver	__label__offensive
tremendous amount power legalizes pizza quickmeme com	__label__offensive
one simply tear kim jong kook name tag	__label__not_offensive
know fb com legendaryfacts kim jong new face vogue	__label__offensive
hello chillis need chicken plastic please imgflip com	__label__offensive
tell daughter going kidnapped quickmeme com	__label__offensive
going release secret fleet build fuck yeah ! quickmeme com	__label__not_offensive
always find kill	__label__not_offensive
wanna know happened like nick said zayn trigger harry zayn liam admitted zarry close im confused	__label__not_offensive
i have trained jedi i have trained batman zeus still think kidnapping family isa good idea memecenter com memecenter	__label__not_offensive
know i am telling mom	__label__offensive
talk liam hemsworth transformation omg	__label__offensive
gay facts fashion	__label__not_offensive
girl 22nd birthday liam sang boys reaction harry face ca not stop laughing larry is real 	__label__not_offensive
hey met crazy here number cal maybe know find kill you 	__label__not_offensive
 liam neeson voice share transphobic memes trans gamestop customer find delete you 138 others comments shares tough guy friend list	__label__not_offensive
darbe wag liam saw first time	__label__offensive
know lyrics wmyb that cool shut up roflbot	__label__offensive
gurrrl hold get dem shoes	__label__not_offensive
mus calm	__label__not_offensive
 voiceover frank madlipz com ordering pizza liam neeson style pizza taken iwillfindyou liamneeson dominos pizzahut papajohns pizzaexpress film movie scene actor hollywood funny funnyshit funnyaf videos parody lol imao hilarious meme memes dailymemes instagood instadaily instameme voiceover frank frank	__label__offensive
liam saw hair goes seriously started singing wrecking ball shut up 	__label__offensive
someone says havent eaten enough liam payne	__label__offensive
asked favourite x - men character apparently bruce jenner inappropriate poslo com ngflip com intemet scavengers	__label__not_offensive
magneto wear purple anymore days fuchsia passed	__label__not_offensive
omg ! ! ! x - men alive ! ! ! 	__label__offensive
prefer chicken cheep ! said real chicken prefegtion	__label__offensive
let tell school made imeur	__label__offensive
x - men : first class drinking game take big swig every time xavier this quickmeme com	__label__offensive
ca not draw cartoons like animated series 90 memecenter com mean look armor 	__label__not_offensive
alat according this ccc father ! 	__label__offensive
lizard wore pants would wear like like this 	__label__offensive
mark zuckerberg delivering rusty trombone re - post photo	__label__offensive
mark zuckerberg coveralls backwards none told zuckerberg memes	__label__not_offensive
travelling taj mahal worth untill abhishek chack dear zuckerberg pose like oops ! ! 	__label__not_offensive
mark zuckerberg owner two biggest social networks planet covers camera microphone maybe too ! 	__label__offensive
let finish school said billionaires ever memecenter com memecenter	__label__offensive
mark zuckerberg giving teeth away share meme comment meth and entered drawing ! 	__label__not_offensive
 nbc friends ask drunk last night recall it attorney general	__label__offensive
mark zuckerberg back facebook bus ! 	__label__offensive
stop sasuke meme focus 10yearchallenge mark zuckerberg stop sasuke meme amp; focus 10yearchallenge 	__label__offensive
little boy runs facebook davidicke com sure interrogating zuckerberg bad lip reading http : ow ly ghzj30jfmex facebook	__label__offensive
put time fuck put time	__label__offensive
arguing someone walk away hear say 011001010111100001110100011001010 1110010011011010110100101101110011 000010111010001100101 breath	__label__offensive
much money mark zuckerberg gave imgflip com	__label__offensive
won zuckerberg giving money ! glitter shitting unicorn too ! <3 memeshappen com	__label__offensive
loves halflings leaf eye watching ! 	__label__not_offensive
second breakfast he probably never heard	__label__offensive
think i am love aragon seen 12 : 48pm	__label__offensive
guy never runs arrows	__label__offensive
best friend like lord rings lord rings marathon	__label__not_offensive
visitors well - wishers distant relations old friends	__label__not_offensive
brace lord rings memes coming memegenerator net	__label__not_offensive
prefer real bilbo said real bilbo perfection	__label__offensive
one simply take scene seriously anymore	__label__offensive
ishould watch lord rings trilogy memeful com	__label__not_offensive
good guy sauron gave gifts developed industry	__label__offensive
gandalf white probably never heard	__label__offensive
would simply walk mordor	__label__offensive
anti - vaxx kid getting nervous third birthday like : 	__label__offensive
sit toilet realize forgot phone things motion cannot undone 	__label__offensive
www catikay tumblr com gandalf white god aragorn ca not ask people they are white 	__label__not_offensive
lord wings	__label__offensive
beacons lit ! 	__label__offensive
supply management implemented 2009 asaway avoid dairy subsidies	__label__not_offensive
test results came back negative flu positive pneumonia imgflip com	__label__not_offensive
everything comes right time patient 	__label__not_offensive
would lose weight hate losing despicablememinions org	__label__not_offensive
dont til coffee memecrunch com	__label__offensive
need love banan s	__label__not_offensive
sorry ca not today sister friends mother grandpa brother grandson uncles fish died yes tragic ! fb com minionquote despicablememinions org	__label__not_offensive
me mature ! ha ! still laugh ketchup bottle farts ! 	__label__not_offensive
teacher pointed ruler said : at end ruler there idiot ! gapbagap us got detention asking end 	__label__offensive
daughter wanted cinderella - themed party invited friends made clean house	__label__offensive
want prince white horse want big floppy donkey cock	__label__offensive
fucking hate minion memes memegenerator net	__label__not_offensive
people ungrateful one ever thanks patience kill them 	__label__offensive
due intense mind fog thoughts grounded notice 	__label__offensive
flag offends need history lesson 	__label__offensive
lonely	__label__not_offensive
what is lour crazy miny minion name first name : mommy credit card number middle name : three numbers back last name : expiration month year	__label__offensive
gonna make voodoo doll give back rub 	__label__offensive
tried cooking dinner wine tonight well glasses forgot even kitchen	__label__offensive
behind every successful person substantial amount coffee ! minion2minion com	__label__not_offensive
swear last words going got this 	__label__offensive
lost mind making effort look it 	__label__offensive
come baby blow	__label__not_offensive
like i am facebook status 	__label__not_offensive
work really again yesterday 	__label__offensive
people say love best feeling think finding toilet diarrhea better 	__label__offensive
here girls : girls wake perfect hair mind eating big mac instead salad wear pounds makeup who would rather spend day sweatpants skinny jeans love comfort t - shirts get guys who popular feels like they are friends stick sneakers instead heels way get everything want need guy tell beautiful 	__label__not_offensive
sorry missed call	__label__not_offensive
bird kniw would shit on 	__label__offensive
people soo full shit ! flushing handles instead ears ! ! 	__label__not_offensive
people voice head says would o not say mine says ay sit back watch fun 	__label__offensive
tried act normal	__label__offensive
moment breathe someone else breathes too ! 	__label__offensive
stress burned calories i would super model 	__label__not_offensive
reason still upset election weak lack coping skills maybe parents never said no you editorial dixon diaz april 2017 issue russians emails electoral college misogyny issue you get way mommy ca not fix child tantrum toy store 	__label__offensive
saya woman work never done maybe that get paid less	__label__offensive
perfect makeup hair outfit sure work out 	__label__offensive
come bro quickmeme com	__label__offensive
sexist memes 2018 real makeameme org	__label__not_offensive
lord rings total harry potter ripofe	__label__offensive
valentines day misogyny memegenerator net	__label__offensive
roses red heart fat valentine cash outside howbow dah	__label__not_offensive
feminist somebody tries insult telling with ideas man ever want marry you power	__label__offensive
iceland president the government bailed people imprisoned banksters; opposite america rest europe did 	__label__offensive
opinions year old male caucasian atheist america australia nstructo gonna bad time quickmeme com	__label__offensive
white girls checking account balances summer spending money ros inflatable unicorns pool : diam in	__label__not_offensive
trans genderqueer russia : pronouns exist francesca visser 21 bad corade reading this 	__label__not_offensive
wont regret extra push fitspoholic tumblr com	__label__offensive
you idiot sandwich	__label__not_offensive
 thelikeguys idont cook idont clean idont want kids i dont date feet sometimes message myex andiprefer rich hotguys years later good men ! oh misogyny uncle	__label__offensive
tam anti religion tam anti sexism anti racism anti homophobia anti violence anti misogyny anti slavery anti ignorance anti child abuse anti oppression anti war religion anti me fb com fatheiss	__label__offensive
idont protest female apartheid misogyny islam muslim countries burquas	__label__offensive
misogyny awesome gonna use scrabble night aussiememes com au	__label__not_offensive
7th rule misogyny women always grateful men everything imgflip com	__label__not_offensive
corgi cute misogynists not memegenerator net	__label__offensive
icleared civil services examination joinedirsas assistant commissioner income tax imgflip com	__label__not_offensive
said girl malnutrition due figure consciousness quickmeme com	__label__not_offensive
admit hukkad d bhukkad insta fb bhukkad destroying corruption like boss narendra modi y 	__label__offensive
degree yale cos want you ! happy valentines day	__label__not_offensive
nitish break lalu come back modi ca not you wyo in appu tweet officeof pappu	__label__not_offensive
got sari thank you ! one wear it without diamond jewellery 	__label__not_offensive
facebook breaks heart say but 	__label__not_offensive
difficulty changing notes think difficult narendra modi change country credits sir ravindra jadeja 	__label__not_offensive
told paramount purposely made sonic ugly gain attention redesign ready imgflip com	__label__offensive
ask shall receive told answer receive quickmeme com	__label__not_offensive
hawkman memegen com	__label__not_offensive
mom i will fix antenna	__label__not_offensive
finally gets girlfriend laina	__label__offensive
looking bad luck brian meme year old daughter walks you made imgur looking bad luck brian meme year old daughter walks by 	__label__not_offensive
hey brian happy birthday	__label__not_offensive
always spell intricate words perfectly first time type aasldfliksdfjalsdfkis immediately make sure spell check still	__label__offensive
makes good luck brian meme scumbag icanhascheezburger com	__label__not_offensive
ohh make bad luck brian meme make shit get featured like everyone else ! memecenter com mame center	__label__offensive
mods remove previous life brian meme want spark outrage people sort new wait till biggus dickus hears fucking bullshit	__label__not_offensive
bad luck brian fucked memecenter com memecenter	__label__offensive
people ends bad luck brian meme something original shit memecenter com memecenter	__label__offensive
coffee addict i am little attached that all coffee memions com	__label__not_offensive
wife tells eating two months later finds wanted fat	__label__offensive
carrier 1 : 26 finally finds luck dictionary	__label__offensive
reads bad luck brian meme gets meme memegenerator net	__label__offensive
finding memo 	__label__not_offensive
really start working oh ! look - nutella memeful com	__label__not_offensive
see bae look i am gonna touch butt 	__label__not_offensive
sweet ! memegenerator net	__label__offensive
so i have spent entire life thinking deep sea angler fish size nerf football horrifying typical specimen seven feet long 	__label__not_offensive
keep singing keep praying eel loving fining jesus imgflip com	__label__offensive
finding emo memecenter com memecenter	__label__not_offensive
biden : friends over obama : dunno ask michelle biden : said ask you obama : 	__label__offensive
michelle start wearing less going	__label__offensive
promises change changes promise memecenter com memetenleri	__label__offensive
barrack obama : said we are best solve issue memecenter com mame center	__label__not_offensive
want someone look way joe biden looks obama 	__label__offensive
try tell obama greatest president ever show whole tiddy tho	__label__not_offensive
gonna leave angry cheeto ! olama memes	__label__not_offensive
pedobama iganhascheepburger com	__label__offensive
first fwek melania clique claim husband hair thin see brain	__label__offensive
job gop created years ! 	__label__offensive
presdent obama reaching female voters politicalmemes blogspot com	__label__offensive
forgot take away everyone guns made imgur	__label__offensive
destroy america memeshappen	__label__offensive
give lunch money ! 	__label__not_offensive
russia leads attacks agianst isis claims thats leader ship obama meme	__label__offensive
michelle obama quote white folks what is wrong america imagine george bush saying black folks what is wrong america still think media bias	__label__offensive
hange change believe hey hil whatchu doing running world 	__label__offensive
oemas baracka flocka flame	__label__not_offensive
saw headline fox news : obama wants quiet 	__label__offensive
3 2 1 dont timmy ! 	__label__offensive
penguin anguin penji evod ck	__label__not_offensive
makes penguin meme via 9gag com wrong penguin memeful com	__label__offensive
climate change could impacting faster rate expected club penguin shutting march 29 	__label__not_offensive
someone made dinosaur noises without ever hearing	__label__not_offensive
know fuck wife daughter get confused bomb syria	__label__not_offensive
friend talks someone know stand silence awesome pictures themetapicture com	__label__offensive
try ask licence fees famous meme forced pay licence fees using popular meme person publishes publishes whole internet gets furious everyone supports	__label__not_offensive
two people like club penguin memes irl	__label__offensive
thinking end universe terrifies shit made imagur yeah i would dead but 	__label__offensive
fight breaks husband comes home finds wife another penguin 	__label__not_offensive
today gonna show gangster clarketwins	__label__offensive
deep	__label__offensive
unknowingly used awkward penguin meme incorrectly made front page anyway everyone made fun yesterday 	__label__offensive
see madagascar penguin meme outlived days well ! join someday ! bountiful harvest ! 	__label__offensive
show friend talent working year hits cool slayer	__label__offensive
tell get sesame street nike	__label__offensive
finally meet bae parents ask living midayse	__label__not_offensive
keayallvill zee always say weird flex okay never weird flex okay never weired flex okay 	__label__offensive
labeled alt right meme pepe beaten rabid anti - trump protesters functional spend life mental facility sad ! 	__label__not_offensive
ready world war pepe pepememe pepememes pepethefrog sadfrog feelsbadman feelsgoodman frog meme memes savepepe rippepe ww3 army	__label__offensive
eat i am unhappy i am unhappy eat feels fat man pepe pepememe pepememes pepethefrog sadfrog feelsbadman feelsgoodman frog meme memes savepepe rippepe fat diet	__label__offensive
pepe frog	__label__not_offensive
me : even think making pepe version inner meme : pepe life via 9gag com	__label__offensive
poo poo cannon pepe improved ver 	__label__not_offensive
reasons livs memes happy pepe ifunny co	__label__not_offensive
high school reunion meet former bully find life school miserable	__label__not_offensive
forgot hell doing ! imgflip com	__label__offensive
dumb girl class : people depression dumb cant happy waste money medicine	__label__offensive
wish happy birthday make	__label__offensive
ahead say shut wesley ! bald - heased fart ! 	__label__not_offensive
hell engineers future forget seatbelts airbags imgflip com	__label__offensive
face make realize picard memes coming	__label__not_offensive
hell hair like zombie apocalypse imgflip com	__label__not_offensive
captain picard picking apples orchard orchard pronounced like picard	__label__offensive
good thing going recent page seing good memes everyone else does really sure much win memecenter com andr4237	__label__not_offensive
fuck commercials louder show memecenter com mamecenter	__label__offensive
captain picard clown college graduation picture memecrunch com	__label__not_offensive
wear pink camo going hunt flamingos 	__label__not_offensive
bravo captain picard ! tea line would complete without picard famous earl grey touch sweet citrus fruit creamy vanilla taste tiny drop honey perfect sitting quarters thinking pensively	__label__offensive
make snow 	__label__offensive
wtf shit reaction noticed like posts memecenter memecenter com memecenter	__label__offensive
obama 1980 2000 2010 2016 nemkutya com putin 1480 1920 1940 2016	__label__not_offensive
soviet russia president assassinate	__label__offensive
would like putin imgija com	__label__offensive
give fuck glasses quickmeme com	__label__offensive
let party quickmeme com	__label__offensive
time soviet reunion	__label__offensive
better grab ham might turkey left christmas bar haha well true russia putin funny trump usa	__label__offensive
right bear arms soviet russia right whole bear picture : imgur	__label__offensive
ran baseball team ran kgb vis stop fuckings me icanhascheezburger co	__label__not_offensive
type send nudes auto corrects send nukes 	__label__offensive
moscow anonymous sources say russia funding russian army cnn 2 : 30 cet intelligence 100 putin actually vladimir	__label__offensive
pop - tarts ccnoe peoppar problems	__label__offensive
washington really hate me could bacause threw rothschild central bank russia 	__label__offensive
look countries used own 	__label__offensive
crimea river	__label__not_offensive
one room understands dangerous man actually	__label__offensive
russia wants ban purchase cigarettes memeful com anyone born 2015 could putin memes resurge value approach trump presidency via r dank meme http : ift tt 2ntzk8h	__label__offensive
guess that short - man syndrome began well least pecs look like boobs imgflip co 	__label__offensive
racist best slaves black memecenter com mamelenteri	__label__not_offensive
danie barnard august boer recon staring ernst roets willem petzer 0 : 26	__label__not_offensive
would racist black people could read	__label__not_offensive
black man asks directions two blocks east police station know right memegenerator co	__label__not_offensive
damm kids days memecenter com com colored things hang trees lights even rabe www	__label__not_offensive
black black black much black much racist much poop 1234 black kids dirt	__label__not_offensive
china patio seems racist 	__label__not_offensive
limits self hating joke	__label__offensive
hero riley make meme + 	__label__offensive
never trust someone blindfold shoelace	__label__offensive
loading afro 50 	__label__offensive
capital one what is wallet 	__label__not_offensive
trump trump racist he realist color sees green wants it diamond silk fox love news	__label__not_offensive
vegas what is vegas isa sure would like visit vegas	__label__offensive
2016 : if criticize president racist 2017 : hate president anyone disagrees racist memes care feelings	__label__not_offensive
boys fun women empowerment memegenerator net	__label__offensive
rahul gandhi speech cannot serious people rahul gandhi speech	__label__not_offensive
dont always give speech make sure party loses 10000 votes ! memecenter com memecenter	__label__offensive
life gives rahui officialtroll bollywood make sure make rahul dravid rahul gandhi	__label__not_offensive
happy birthday rahul gandhi rvcj www rvcj com live example happens parents allow son wants life	__label__not_offensive
narendra bhai rahul back when thr next comedy show 	__label__not_offensive
life gives lemons empower women http : chuornot netcurate com stories rahul - gandhi - meme	__label__not_offensive
rahul gandhi resetting twitter password save hacking again laughing colours laughingcolours com pappu super busy 	__label__not_offensive
india rahul president indian national cong mal hypothesis nus nus nus nus nus nus	__label__offensive
politician hater bebaba rahul gandhi jai hind bcbaba	__label__offensive
destroy america already	__label__offensive
donald trump stole hair memegenerator net	__label__offensive
nan	__label__not_offensive
bill looking at 	__label__offensive
dear liberals impeach	__label__offensive
nan	__label__not_offensive
orange new black	__label__offensive
nan	__label__offensive
i am fancy even showers golden	__label__not_offensive
happy birthday sweetheart	__label__not_offensive
happy birthday happy - wishes net happy see growing	__label__not_offensive
boss sorry wrong number ! 	__label__offensive
picture worth thousand words	__label__offensive
foreign policy mess united states hell toupee imgflip com	__label__offensive
vote president apparently real state manager become president	__label__offensive
marco stop trying confuse people facts 	__label__offensive
everything fought occupy democracy wants detroy	__label__offensive
trummemes net shake hands hand would look tiny	__label__offensive
entered another dimension trumpmemes net	__label__not_offensive
tall guy ! quickmeme com	__label__offensive
sotruefacts : 1731 child uccess kid meme made enough money internet popularity fund dad kidney transplant sotruefacts com	__label__offensive
imgur fix meme generator already fire intern keeps breaking stuff egenerator com	__label__offensive
old man asks bus driver stop let off bus driver says no do old man grabs bag seat light cig gets kicked bus immediately made imagur	__label__offensive
amazing facts thanks internet popularity success kid made enough money fund dad kidney transplant 	__label__offensive
e t arrived phone invented imgflip com	__label__offensive
didnt watch video ca not wait hear excuse imgflip com	__label__not_offensive
tsunami silent honest silent information technology memes information technology memes island silent queue ueue silent issue developer silent	__label__not_offensive
yes i am uncovered flight deck hands pocket there nothing	__label__offensive
says teaching stressful i am feel great ! 	__label__offensive
advances technology future would think would found cure baldness imgflip com	__label__offensive
even 4 20 ghz quadcore memedroid cant t process bullshit	__label__offensive
chuck norris got computer virus died memegenerator net	__label__not_offensive
someone tries show meme instagram demon 	__label__offensive
whenever knock down stay ground challenge accepted hellaninja ifunny mobi	__label__offensive
hate using touch pad ate mouse	__label__offensive
blame technology 2016 1916	__label__not_offensive
apple card new magnises card number cvv security code expiration date signature marisa robertson 1 : 39 mar 2019	__label__offensive
moment see dad holding cell phone	__label__not_offensive
tdo not always use internet explorer usually download better browser imgflip com	__label__not_offensive
dawg heard liked macs broke windows imgflip com	__label__not_offensive
rival impact nuclear weapons yet remains largely unregulated space gerd	__label__not_offensive
daddy whats future place advanced technology entertainment violence 	__label__offensive
impressed technology download beer	__label__offensive
ificantfinish game sudoku 374 twill declare war south korea know memes	__label__not_offensive
sure critical issue dramatic customer www callcentermemes com	__label__offensive
person rarely know fix issue i am better google	__label__not_offensive
number people refuse google question damn high ! made impur	__label__not_offensive
look hands they are white mine appear african - american say black	__label__not_offensive
get sales enablement platform ! everybody gets sales enablement platform ! 	__label__not_offensive
okay	__label__offensive
grandma trying use computer takes technology memes com	__label__offensive
technology bring united states knees	__label__offensive
mean tell minesweeper game country megenerator net	__label__not_offensive
come back america you 	__label__offensive
stepped land mine	__label__offensive
telling dog house memegenerator net	__label__offensive
ahead tell first world problems quickmeme com armed dangerous third world kid memes quickmeme	__label__offensive
play whole game soccer sister died nobody stepped land mine food	__label__offensive
started bottom bottom	__label__offensive
woman heart deep ocean secrets titanic	__label__not_offensive
iceberg destroyed titanic zuckerberg destroyed life students	__label__not_offensive
wants watch titanic get put 2nd tape made imgur	__label__not_offensive
titanic die me irl	__label__not_offensive
jackp boyancy in stuff ben remember titanic imgflip com	__label__offensive
buys iphone find droid looking soft ball quickmeme com	__label__not_offensive
cancer take life takes jobs 	__label__offensive
 do want spend rest life selling sugared water want chance change world 	__label__offensive
yardstick quality people used environment excellence expected steve jobs digital aformula learn grow influence social media : https : stevenaitchison mykaja bi com p your - digital - formulacoaches	__label__offensive
hey macs god now memegenerator net	__label__offensive
sad news steve jobs died need great new visionary 	__label__offensive
told slaves gonna free one picked cotton tumbuto got first place he gonna get one less whipping imao ilovelife	__label__not_offensive
college important steve jobs dropped he dead memecenter com	__label__not_offensive
dat face make wakell realise lifeis rolling away imgflip com	__label__offensive
work customer starts yelling ca not anything the customers always right 	__label__not_offensive
ginger seal craves sustenance sole found	__label__offensive
way work cuta guy give finger	__label__offensive
interviewer asked navy seal learn foreign languages like green berets ma am send talk imgflip com	__label__offensive
wants call someone gay chooses seal meme quickmeme com	__label__not_offensive
want get banned like puffin that get banned like puffin 	__label__offensive
cutting wrapping paper scissors start glide unbelievable ludicrus christmas seal 	__label__offensive
check fridge theres food left	__label__offensive
frogman nice nickname quickmeme com	__label__offensive
choice hat bro ! imgflip com	__label__offensive
top class navy seal training navy seal training imgflip com	__label__offensive
human ! funnyi memecenter com mamecenter	__label__not_offensive
dream kill dude haphazardly get rid body mgom wake realise i am murderer imgflip com scumbag brain satisfied seal make strange bedfellows 	__label__offensive
making sorry eyes mum sarcastically insulting lady trying job	__label__offensive
ultra gaaaaaayyyy gay meme seal imgurl	__label__not_offensive
come back reddit couple months surprised pickachu meme dead u bugga47 surprised happy seal confuses	__label__not_offensive
that one way discover victoria secret imgflip com	__label__not_offensive
surprise shared prusunod internet scavengers	__label__offensive
sexist via 9gag com lady called history misogynistic comments must period	__label__offensive
god even make sandwich constant updates best funny pictures web lolsnaps com	__label__offensive
mal charlwood shared laugh croak photo may wife hand grenade common find laugh croak remove ring house gone	__label__not_offensive
took minutes get home google maps says takes she ! 	__label__offensive
feminism keep using word think means think means memegenerator net	__label__offensive
alexis isabel glexi4prez everyone google search actor count many men come one fucking woman holy shit hahahaha 8 14 15 12 : 26am eee - in well may typed word actress fuckong idiot	__label__not_offensive
said wants hear ocean told i would bring back seashell mematic net	__label__offensive
texted man min ago still responded daddyissues entube i am single right now 	__label__offensive
country enter women section metro get arrested women freely enter man section take seat stand then 	__label__not_offensive
silly girl art base 3 - 6 dec thats kitchen memecenter com mamelenler	__label__offensive
mean tell making fricatives 	__label__not_offensive
tell daddies love boobies too 	__label__offensive
mean tell boobs milk skeptical baby	__label__not_offensive
thing need unshakeable belief yourself ! wouluarvey do 	__label__not_offensive
appjuice respect you excellent attorney valuable member firm usa	__label__offensive
keep calm think what would harvey specter do whisper	__label__not_offensive
work longer introduce pic collage	__label__not_offensive
harvey specter harveyllb suits like splitsvilla 	__label__offensive
happy birthday gurl ! memegenerator net	__label__offensive
damaged people strong know survive instagram words2success	__label__offensive
loyalty two - way street i am asking getting me 	__label__not_offensive
fuck sky	__label__offensive
simple kill spider - man quickmeme com	__label__offensive
spider - man watched infinity war imgflip com	__label__offensive
god order vindaloo curry marvel com	__label__offensive
stand back proudly hosted photobucket i am gonna try science	__label__not_offensive
rare image united airlines staff training re - accommodate passenger facebook com the nationofditkovich	__label__not_offensive
going spiderman blow - up spiderman 	__label__offensive
i am gonna lie kid never candy	__label__offensive
hit struck smooth criminal funny being com	__label__offensive
prefer real aunt may said real aunt may perfection 	__label__offensive
add water ! quickmeme com	__label__not_offensive
here deadpool made dream come true aaaargh ! ! ! 	__label__offensive
moment spider man slept iron man explain end	__label__not_offensive
last time peter i am hitler stop asking autographs	__label__offensive
last time drop acid salvador dali 	__label__offensive
thatll teach orphans fuck	__label__not_offensive
faggot detector charts ! 	__label__not_offensive
real dad spiderman memes 60s spiderman memes funny spiderman memes	__label__offensive
like sports could play something sports quickmeme com	__label__offensive
thought ran insults usa max score vapey mcdoucheface 16 400 deductions 1 400 omega score 15 000 sports memes	__label__not_offensive
balls one kick must record trendingnuts com	__label__offensive
make fun unibrow one time ! kentucky sports memes	__label__offensive
dad what is taking game winning shot know son i am lebron james	__label__offensive
cr7 : the god football sent best ! messi messi : dont remember sending trendingnuts com	__label__offensive
europe cancel match snowing hard found veryfunnypics eu meanwhile russia	__label__offensive
kid best little league team tell future mlb imgflip com	__label__offensive
craziest dream csn muut facebook com themlbnemes dis actually went astros game	__label__offensive
expect things them michael jordan bulls	__label__not_offensive
gate locking grim karen adult swim let in need tell going okayyyyyy adult swim 	__label__not_offensive
winter book com nbamcamine bring girl nba playoffs she will get bored	__label__offensive
moment tom enough jerry crap imgflip com	__label__offensive
get tired going work every day start hitting golf course looking old rich men like	__label__offensive
 10 year challenge created zuckerberg optimise face recognition software	__label__offensive
fbi : need start updating facial recognition database facebook : could year challenge users fbi : 	__label__not_offensive
year olds seeing others years challenge	__label__offensive
desirable manin : 2009 2019	__label__offensive
employees 10 yearschallenge bulla memes i t memes 2009 2019	__label__not_offensive
donald trump orealdonald trump we build many walls enough bridges isaac newton 4 : 11 oct 2013 twitter web client 79 8000 retweets 66 2000 likes mod whole operation idea	__label__offensive
ca not year challenge cause pewdiepie subscriber saved cringe ask me 	__label__not_offensive
dear avengers movie conspiracy theorists quantum realm work way ! shut bed ! 	__label__offensive
ig : marvel memes gives right what is difference us marvel memes get avengers	__label__offensive
yes really love thor loki	__label__offensive
tony looks terror thanos unzips pants revealing two infinity stones	__label__offensive
tell thanos i am coming marvel studios avengers revenge wick	__label__offensive
marvel meme made dc marvel - comics movies love both ! ca not choose wonti thats i am talking about ! trick question ! agent coulson	__label__offensive
think downloaded wrong avengers movie dark morbid avengers infinity war	__label__not_offensive
every time already know verse understood reference 	__label__offensive
beautiful hell really powerful hell lead avengers really hell	__label__offensive
avengers endgame movie endgame	__label__not_offensive
pho king noodles look like want pho king noodles quickmeme com	__label__not_offensive
want answers	__label__not_offensive
one drunk baby meme going make one disappear nap time 9gag com gag 5186230	__label__not_offensive
tell penguin bad weave keep messing ayoola weave eating pavement ! quickmeme com	__label__offensive
gimme capri sun bitch thirsty quickmeme com	__label__offensive
awkward moment realize ob sacked number points scored preseason	__label__offensive
barry i am afraid we are going make serious changes around here let start diaper 	__label__not_offensive
leave gun take cheerios memecenter com godfather85	__label__offensive
godfather davis raider nation quotes just win baby commitment excellence sb lets get win texans move next game madd maxx graphixs onenation loyalty crew sba4l	__label__not_offensive
dam ready work imgflip com	__label__not_offensive
mom said alcohol enemy jesus said love thy enemy matter resolved crazyhyence com	__label__offensive
b word call woman beautiful bitches love called beautiful memegenerator com	__label__offensive
animated memes wait it 	__label__offensive
barney stinson going legen wait dary - whatever life legendary unless friends see it barney stinson barney stinson going legen wait day 	__label__not_offensive
call cow falling cliff ledge - end wait dairy memes funny pics frabz com	__label__offensive
himym fact scenesofhimym times series barney suit up know himym https : t co kwecepesms	__label__offensive
challenge accepted imgflip com	__label__offensive
tried friendzoned	__label__offensive
robin thicke rcedes ishio real barney stinson imgflip com	__label__offensive
ido research i am legen wait it dary imgflip com	__label__not_offensive
face friend gives crush walks room 	__label__offensive
nightmares made this 	__label__not_offensive
lying let	__label__offensive
hello ther memegenerator net	__label__offensive
ability make three generations people laugh socks	__label__offensive
baby mr bean funny picture	__label__offensive
seat take one	__label__offensive
one moment find whati mean memecrunch com	__label__offensive
onbamemes akers lakception cow 4506 kobe mr bean bryant ! credit : basketball pics	__label__offensive
bean dr house double epicness know memes	__label__offensive
mr bean face reinvented spikepheonix ifunny ifunny mobi	__label__not_offensive
face memecenter com theres substitute math class	__label__offensive
says wendell quickmeme com	__label__not_offensive
mr bean : nba edition ! credit alfred justin montoya	__label__offensive
mr bean taught one thing life enjoy company instead expecting someone else make happy 	__label__not_offensive
amycalvins pics mr bean photoshopped pop culture moments hysterical trollery	__label__offensive
matter old grow dekh bhai always enjoy watching mr bean double tap seen show amazingcomedian sotalented inspiration ommy 007	__label__offensive
idontalways playthe piano idoies umbrella irst org girls entertainment	__label__not_offensive
thanks making childhood awesome mr bean 	__label__offensive
new bean figure pretty life like	__label__offensive
real mr bean real mr bean	__label__not_offensive
 dcmarvel memes tag friend open phone see	__label__not_offensive
still know nothing ! 2017	__label__offensive
create hashtag this no time explain grab helichrysum hop car ! ! ! essentialoilstyle com	__label__offensive
best around nothing ever gonna keep down ralph macchio	__label__offensive
oils good por cutting poul smell body buribd back yard asking friend essentialoilstyle com	__label__not_offensive
going on - and - on - and - on problems i am nodding head suggesting oils know i am listening right 	__label__not_offensive
tuesday mardi gras wednesday valentine friday chinese new year celebrate full force; i will waiting end week digestive blend essentialoilstyle com	__label__offensive
must watch movies 2017 iti chennai memes maanagaram handful diverse characters find extraordinary situations interlinked one another	__label__not_offensive
less talking planning soda junk food complaining worrying doubting lazing around frowning insecurity weakness ignorance hate ungratefulness listening tea salads encouraging hoping believing working smiling trust confidence understanding love gratitude easy guide making rest 2017 best 2017 	__label__offensive
time fantasy one time unless make time arhtisticlicense com	__label__not_offensive
starting point every good idea what if arhtistic license com	__label__not_offensive
