LET ME TELL YOU ABOUT MY SCHOOL made on imeur	__label__slight
X-MEN: FIRST CLASS DRINKING GAME TAKE A BIG SWIG EVERY TIME XAVIER DOES THIS... quickmeme.com	__label__slight
ALAT ACCORDING TO THIS... CCC YOU ARE NOT THE FATHER!	__label__very_offensive
If a lizard wore pants would he wear them like this or like this?	__label__very_offensive
MARK ZUCKERBERG IS DELIVERING A RUSTY TROMBONE IF YOU RE-POST THIS PHOTO	__label__slight
IF MARK ZUCKERBERG. OWNER OF THE TWO BIGGEST SOCIAL NETWORKS ON THE PLANET COVERS HIS CAMERA AND MICROPHONE. MAYBE YOU SHOULD TOO!	__label__very_offensive
LET'S FINISH SCHOOL SAID NO IT BILLIONAIRES EVER. memecenter.com MemeCenter	__label__slight
"﻿NBC WHEN YOUR FRIENDS ASK HOW DRUNK YOU WERE LAST NIGHT ""I do not recall it..."" ATTORNEY GENERAL I DO"	__label__slight
NO  MARK ZUCKERBERG WE WON'T GO TO THE BACK OF THE FACEBOOK BUS!	__label__slight
"Stop sasuke meme & focus on #10yearchallenge Mark Zuckerberg ""Stop the Sasuke meme &amp; focus on #10yearchallenge"""	__label__slight
THIS LITTLE BOY RUNS FACEBOOK?? DAVIDICKE.COM EL SURE HE DOES 'INTERROGATING #ZUCKERBERG' — A Bad Lip Reading http://ow.ly/GHZJ30jFmEx #Facebook	__label__slight
You put in the TIME FUCK PUT IN THE TIME	__label__very_offensive
When you're arguing with someone but you walk away and hear them say *011001010111100001110100011001010 1110010011011010110100101101110011 000010111010001100101' under their breath	__label__slight
HOW MUCH MONEY MARK ZUCKERBERG GAVE OUT imgflip.com	__label__very_offensive
YOU WON.ZUCKERBERG IS GIVING YOU THE MONEY! AND A GLITTER SHITTING UNICORN  TOO!<3 memeshappen.com	__label__very_offensive
What about second breakfast? He's probably never heard of it	__label__hateful_offensive
I think I'm in love with you  Aragon. Seen 12:48pm	__label__very_offensive
THIS GUY NEVER RUNS OUT OF ARROWS	__label__slight
I prefer the real Bilbo I said the REAL Bilbo Perfection	__label__very_offensive
ONE DOES NOT SIMPLY TAKE THIS SCENE SERIOUSLY ANYMORE	__label__slight
GOOD GUY SAURON GAVE OUT GIFTS DEVELOPED INDUSTRY	__label__very_offensive
I AM GANDALF THE WHITE NOW YOU'VE PROBABLY NEVER HEARD OF ME	__label__slight
I would simply walk into Mordor for you	__label__very_offensive
Anti-vaxx kid getting nervous on his third birthday like:	__label__slight
When you sit on the toilet and realize you forgot your phone. Things are now in motion that cannot be undone.	__label__very_offensive
Lord of the Wings	__label__slight
The beacons are lit!	__label__slight
DONT DO IT TIL YOU'VE HAD YOUR COFFEE memecrunch.com	__label__slight
"MY TEACHER POINTED ME WITH HIS RULER AND SAID: ""AT THE END OF THIS RULER THERE'S AN IDIOT!"" oo gapbagap.us I GOT DETENTION AFTER ASKING WHICH END."	__label__very_offensive
My daughter wanted Cinderella-themed party  so i invited all her friends over and made them clean the house !	__label__very_offensive
I DON'T WANT A PRINCE ON A WHITE HORSE. I WANT A Big floppy donkey cock	__label__very_offensive
PEOPLE ARE SO UNGRATEFUL. No one ever thanks me for having the patience not to kill them.	__label__very_offensive
Due to an intense mind fog  all of my thoughts have been grounded until further notice.	__label__very_offensive
If this flag offends u u need a history lesson..	__label__slight
what's your Lour CRAZY miny T minion name??? first name: your mommy's credit card number middle name: the three numbers on the back last name: the expiration month/year	__label__slight
Gonna make a voodoo doll of myself and give it a back rub.	__label__very_offensive
I tried cooking dinner with wine tonight. It didn't go so well  after 5 glasses i forgot why i was even in the kitchen	__label__slight
"I swear my last words are going to be ""I got this."""	__label__very_offensive
I have lost my mind and i am making no effort to look for it.	__label__slight
Work  really? Again? Didn't I just do that yesterday?	__label__slight
People say love is the best feeling. But I think finding a toilet when you are having diarrhea is better.	__label__slight
IF I WAS A BIRD  I KNIW WHO I WOULD SHIT ON.	__label__slight
Most people's voice In their head says 'Don't say it Mine says 'say it  sit back and watch  It will be fun'	__label__slight
I TRIED TO ACT NORMAL	__label__slight
That moment when you breathe and someone else breathes too!	__label__very_offensive
"The reason you're still upset about the election is because you're weak and lack coping skills. Maybe your parents never said ""no"" to you. Editorial by Dixon Diaz 21 April 2017 The issue is not Russians or emails or the Electoral College or misogyny. The issue is you. You didn't get your way and your mommy can't fix it for you  so you're the child having a tantrum in the toy store."	__label__slight
THEY SAYA WOMAN'S WORK IS NEVER DONE MAYBE THAT'S WHY THEY GET PAID LESS	__label__slight
"PERFECT MAKEUP HAIR AND OUTFIT? SURE... YOU'RE HERE TO WORK OUT"""	__label__slight
COME AT ME BRO quickmeme.com	__label__very_offensive
LORD OF THE RINGS? TOTAL HARRY POTTER RIPOFE	__label__very_offensive
WHEN ITS VALENTINES DAY AND YOU HAVE MISOGYNY memegenerator.net	__label__slight
"When you are a feminist and somebody tries to insult you by telling you ""with these ideas no man will ever want to marry you"" YOU HAVE NO POWER HERE"	__label__slight
"Iceland President “The government bailed out the people and imprisoned the banksters; the opposite of what America and the rest of Europe did."""	__label__slight
IF YOUR OPINIONS AREN'T THAT OF A 20 YEAR OLD MALE CAUCASIAN ATHEIST FROM AMERICA OR AUSTRALIA 'NSTRUCTO YOU'RE GONNA HAVE A BAD TIME quickmeme.com	__label__slight
YOU WONT REGRET THAT EXTRA PUSH FITSPOHOLIC.TUMBLR.COM	__label__slight
"@TheLikeGuys IDONT COOK IDONT CLEAN. IDONT WANT KIDS. İDONT DATE UNDER 6 FEET. SOMETIMES I MESSAGE MYEX. ANDIPREFER RICH HOTGUYS. - 10 YEARS LATER WHERE ARE ALL THE GOOD MEN!? ""oh  misogyny."" - Uncle"	__label__hateful_offensive
TAM NOT ANTI RELIGION. TAM ANTI SEXISM ANTI RACISM ANTI HOMOPHOBIA ANTI VIOLENCE ANTI MISOGYNY ANTI SLAVERY ANTI IGNORANCE ANTI CHILD ABUSE ANTI OPPRESSION ANTI WAR RELIGION IS ANTI ME. FB.COM A FATHEISS	__label__slight
IDONT PROTEST FEMALE APARTHEID AND MISOGYNY UNDER ISLAM IN MUSLIM COUNTRIES BURQUAS	__label__slight
CORGI'S ARE CUTE MISOGYNISTS ARE NOT. memegenerator.net	__label__very_offensive
ADMIT IT HUKKAD D/BHUKKAD INSTA fb/Bhukkad HE IS DESTROYING CORRUPTION LIKE A BOSS Narendra Modi (y) B|	__label__slight
WHAT IF I TOLD YOU PARAMOUNT PURPOSELY MADE SONIC UGLY TO GAIN ATTENTION  AND HAS THE REDESIGN READY TO GO imgflip.com	__label__slight
Finally gets a girlfriend laina Her	__label__slight
"I DON'T ALWAYS SPELL INTRICATE WORDS PERFECTLY THE FIRST TIME BUT WHEN I DO  I TYPE ""AASLDFLIKSDFJALSDFKIS"" IMMEDIATELY AFTER TO MAKE SURE SPELL CHECK IS STILL ON"	__label__slight
Ohh I should make a bad luck brian meme... I will make him shit himself then I will get featured like everyone else! memecenter.com Mame Center	__label__hateful_offensive
OH BAD LUCK BRIAN YOU'RE SO FUCKED memecenter.com MemeCenter	__label__slight
"How people ends the bad luck brian meme Something original ""Shit"" memecenter.com MemeCenter"	__label__slight
WIFE TELLS HIM SHE'S EATING FOR TWO 9 MONTHS LATER HE FINDS OUT SHE JUST WANTED TO BE FAT	__label__slight
Carrier 1:26 AM FINALLY FINDS LUCK... IN THE DICTIONARY	__label__very_offensive
READS A BAD LUCK BRIAN MEME GETS HER OWN MEME memegenerator.net	__label__hateful_offensive
SWEET! memegenerator.net	__label__slight
JUST KEEP SINGING  JUST KEEP PRAYING  JUST EEL LOVING FINING JESUS imgflip.com	__label__slight
Biden: Can I have some friends over? Obama: I dunno... Ask Michelle. Biden: She said to ask you. Obama:	__label__slight
When Michelle start wearing less & going out more	__label__slight
PROMISES CHANGE CHANGES PROMISE memecenter.com Memetenleri	__label__slight
"3 KK ""I want someone to look at me the way Joe Biden looks at Obama."""	__label__slight
i am pedobama IGANHASCHEEPBURGER.COM	__label__slight
First off Fwek Melania & the clique she claim  he husband hair so thin I can see his brain	__label__slight
The only job the GOP created in 4 years!	__label__slight
PRESDENT OBAMA REACHING OUT TO FEMALE VOTERS POLITICALMEMES.BLOGSPOT.COM	__label__slight
FORGOT TO TAKE AWAY EVERYONE'S GUNS made on imgur	__label__slight
I  CAN DESTROY AMERICA MemesHappen	__label__very_offensive
RUSSIA LEADS IN ATTACKS AGIANST ISIS CLAIMS THATS NOT LEADER SHIP Obama meme	__label__slight
"Michelle Obama ... Quote ""White Folks Are What's Wrong With America"" Now Imagine George Bush Saying “Black Folks Are What's Wrong With America"" Still Think There Is No Media Bias"	__label__very_offensive
HANGE CHANGE WE CAN BELIEVE IN Hey Hil  whatchu doing? Running the world.	__label__very_offensive
Saw this with a headline on Fox News: Obama wants us to be quiet.	__label__very_offensive
3...2...1..DONT DO IT TIMMY!	__label__slight
MAKES A PENGUIN MEME VIA 9GAG.COM WRONG PENGUIN MEMEFUL.COM	__label__very_offensive
FRIEND TALKS TO SOMEONE YOU DON'T KNOW JUST STAND THERE IN SILENCE more awesome pictures at THEMETAPICTURE.COM	__label__slight
the two people who like my club penguin memes me me irl	__label__slight
THINKING ABOUT THE END OF THE UNIVERSE TERRIFIES THE SHIT OUT OF ME made on imagur Yeah  I'd be dead but...	__label__very_offensive
today im gonna show you how to be a gangster Clarketwins	__label__very_offensive
it's not that deep	__label__very_offensive
UNKNOWINGLY USED THE AWKWARD PENGUIN MEME INCORRECTLY MADE THE FRONT PAGE ANYWAY This is for everyone that made fun of me yesterday.	__label__very_offensive
When you see the madagascar penguin meme outlived it's 3 days OH WELL! YOU'LL JOIN US SOMEDAY! What a bountiful harvest!	__label__slight
"when you show your friend a talent you have been working for year and hits you with the ""o cool' Slayer"	__label__slight
when they don't tell me how to get to sesame street NIKE	__label__slight
"Keayallvill zee they always say ""weird flex but okay"" but never ""weird flex but okay"" but never ""weired flex  are you okay?"""	__label__slight
i am ready for world war 3 pepe pepememe pepememes pepethefrog sadfrog feelsbadman feelsgoodman frog meme memes savepepe rippepe ww3 army	__label__very_offensive
I EAT BECAUSE I'M UNHAPPY AND I'M UNHAPPY BECAUSE I EAT. feels fat man pepe pepememe pepememes pepethefrog sadfrog feelsbadman feelsgoodman frog meme memes savepepe rippepe fat diet	__label__slight
Me: Don't even think of making a Pepe version of inner me meme: But Pepe is life... VIA 9GAG.COM	__label__slight
I forgot what the hell I was doing! imgflip.com	__label__slight
DUMB GIRL IN MY CLASS: PEOPLE WITH DEPRESSION ARE DUMB WHY CANT THEY JUST BE HAPPY AND NOT WASTE MONEY ON MEDICINE	__label__slight
DON'T JUST WISH FOR A HAPPY BIRTHDAY MAKE IT SO	__label__very_offensive
HOW IN THE HELL... DID ENGINEERS OF THE FUTURE... FORGET SEATBELTS AND AIRBAGS imgflip.com	__label__very_offensive
Captain Picard  picking apples in an Orchard Orchard  pronounced like picard	__label__very_offensive
WHY THE FUCK ARE COMMERCIALS LOUDER THAN THE TV SHOW memecenter.com MameCenter	__label__very_offensive
Bravo Captain Picard! What Tea line would be complete without Picard's famous Earl Grey? It has a touch of sweet citrus fruit with a creamy vanilla taste and a tiny drop of honey. Perfect for sitting in your quarters and thinking pensively	__label__slight
MAKE IT SNOW.	__label__slight
WTF IS THIS SHIT? My Reaction when I noticed that i can like my own posts on memecenter memecenter.com MemeCenter	__label__slight
IN SOVIET RUSSIA PRESIDENT ASSASSINATE YOU	__label__slight
WOULD YOU LIKE SOME PUTIN? imgija.com	__label__slight
THESE ARE MY NOT GIVE A FUCK GLASSES quickmeme.com	__label__hateful_offensive
LET'S PARTY quickmeme.com	__label__slight
IT'S TIME FOR OUR SOVIET REUNION	__label__very_offensive
BETTER GRAB A HAM BECAUSE THERE MIGHT NOT BE ANY TURKEY LEFT BY CHRISTMAS bar Haha.. Well True.. russia putin funny trump usa	__label__slight
RIGHT TO BEAR ARMS? IN SOVIET RUSSIA  WE HAVE RIGHT TO WHOLE BEAR picture:imgur	__label__very_offensive
"When you type ""send nudes"" but it auto corrects to ""send nukes"""	__label__slight
Moscow Anonymous sources say that Russia is funding the Russian Army CNN 2:30 PM CET Intelligence 100 Putin is actually Vladimir	__label__slight
pop-tarts CCNOE PEOPPAR me all of my problems	__label__very_offensive
Why does Washington really hate me? Could it be bacause I threw out the Rothschild Central Bank from Russia?	__label__slight
Look at all those countries I used to own.	__label__hateful_offensive
She's the only one in the room who understands how dangerous this man actually is	__label__slight
RUSSIA WANTS TO BAN THE PURCHASE OF CIGARETTES MEMEFUL.COM FOR ANYONE BORN AFTER 2015 Could Putin memes resurge in value as we approach Trump's presidency? via /r/dank_meme http://ift.tt/2ntZk8H	__label__very_offensive
AND I GUESS THAT'S WHEN MY SHORT-MAN SYNDROME BEGAN | OH WELL  AT LEAST MY PECS LOOK LIKE BOOBS... imgflip.co.	__label__very_offensive
THERE ARE LIMITS self hating Joke here	__label__very_offensive
HERO YOU GO RILEY Make a Meme+	__label__very_offensive
NEVER TRUST SOMEONE YOU CAN BLINDFOLD WITH A SHOELACE	__label__very_offensive
LOADING AFRO 50%	__label__slight
VEGAS? ... WHAT'S THIS VEGAS? ISA SURE WOULD LIKE TO VISIT THIS VEGAS	__label__very_offensive
WHY SHOULD BOYS HAVE ALL THE FUN WHAT ABOUT WOMEN EMPOWERMENT? memegenerator.net	__label__slight
I DONT ALWAYS GIVE A SPEECH BUT WHEN I DO  I MAKE SURE MY PARTY LOSES 10000 VOTES! MemeCenter.com MemeCenter	__label__slight
INDIA AT Mr Rahul President of the Indian National Cong AND WHAT IS YOUR 8 Mal HYPOTHESIS? NUS NUS KV NUS NUS KY NUS NUS	__label__slight
THE ONLY POLITICIAN WITH NO HATER @bebaba RAHUL GANDHI. Jai Hind.. I bcbaba	__label__slight
I WILL DESTROY AMERICA ! I ALREADY DID	__label__slight
DONALD TRUMP STOLE MY HAIR memegenerator.net	__label__hateful_offensive
What is Bill looking at?	__label__slight
DEAR LIBERALS IMPEACH THIS	__label__slight
ORANGE IS THE NEW BLACK	__label__slight
	__label__very_offensive
IT'S ME BOSS... SORRY  YOU HAVE THE WRONG NUMBER!	__label__slight
A PICTURE IS WORTH A THOUSAND WORDS	__label__slight
FOREIGN POLICY? MESS WITH THE UNITED STATES & THERE WILL BE HELL TOUPEE imgflip.com	__label__slight
VOTE FOR ME AS PRESIDENT BECAUSE NOW APPARENTLY ANY REAL STATE MANAGER CAN BECOME PRESIDENT	__label__slight
Marco  stop trying to confuse the people with FACTS.	__label__very_offensive
EVERYTHING I FOUGHT FOR occupy Democracy HE WANTS TO DETROY	__label__very_offensive
TRUMMEMES.NET WON'T SHAKE HANDS BECAUSE HIS HAND WOULD LOOK SO TINY	__label__slight
THAT TALL GUY! quickmeme.com	__label__very_offensive
sotruefacts:#1731 The child from the 'Success Kid' meme made enough money through his internet popularity to fund his dad's kidney transplant sotruefacts.com	__label__very_offensive
IMGUR  FIX THE MEME GENERATOR ALREADY AND FIRE THAT INTERN THAT KEEPS BREAKING STUFF egenerator.com	__label__slight
"OLD MAN ASKS BUS DRIVER TO STOP AND LET HIM OFF. BUS DRIVER SAYS ""NO CAN DO"". OLD MAN GRABS HIS BAG FROM HIS SEAT  LIGHT A CIG  AND GETS KICKED OFF THE BUS IMMEDIATELY. Made on imagur"	__label__very_offensive
"Some Amazing Facts Thanks to his Internet popularity  ""success kid"" made enough money to fund his dad's kidney transplant."	__label__hateful_offensive
WHAT IF E.T. HAD ARRIVED BEFORE THE 'PHONE WAS INVENTED? imgflip.com	__label__very_offensive
YES  I'M UNCOVERED ON THE FLIGHT DECK WITH MY  HANDS IN MY POCKET NO  THERE'S NOTHING YOU CAN DO ABOUT IT	__label__very_offensive
WHO SAYS TEACHING IS STRESSFUL? I'M 39 AND I FEEL GREAT!	__label__slight
WITH ALL THE ADVANCES IN TECHNOLOGY IN THE FUTURE YOU WOULD THINK THEY WOULD HAVE FOUND A CURE FOR BALDNESS imgflip.com	__label__very_offensive
Even my 4.20 ghz quadcore i7 Memedroid Cant't process your bullshit	__label__slight
When someone tries to show you a meme on Instagram DEMON.	__label__slight
Whenever you knock me down. I will not stay on the ground Challenge Accepted HellaNinja ifunny.mobi	__label__slight
I HATE USING THIS TOUCH PAD BUT I HAVE TO BECAUSE I ATE THE MOUSE	__label__very_offensive
Apple Card is the new Magnises. No card number No CVV security code No expiration date No signature 59 Marisa Robertson 1:39 PM - 25 Mar 2019	__label__very_offensive
DADDY  WHATS THE FUTURE? IT IS A PLACE OF ADVANCED TECHNOLOGY AND ENTERTAINMENT AND VIOLENCE.	__label__slight
I WON'T BE IMPRESSED WITH TECHNOLOGY UNTIL I CAN DOWNLOAD A BEER	__label__very_offensive
NOT SURE IF CRITICAL ISSUE OR JUST VERY DRAMATIC CUSTOMER www.callcentermemes.com	__label__very_offensive
OKAY	__label__hateful_offensive
WHEN YOU GRANDMA TRYING TO USE A COMPUTER SHE TAKES TECHNOLOGY memes.com	__label__slight
WITH THIS TECHNOLOGY WE WILL BRING THE UNITED STATES TO ITS KNEES	__label__slight
COME BACK TO AMERICA WITH YOU?	__label__hateful_offensive
STEPPED ON LAND MINE	__label__very_offensive
SO YOU'RE TELLING ME THAT YOUR DOG HAS A HOUSE memegenerator.net	__label__very_offensive
GO AHEAD AND TELL ME ALL YOUR FIRST WORLD PROBLEMS quickmeme.com Armed and Dangerous Third World Kid memes quickmeme	__label__slight
PLAY A WHOLE GAME OF SOCCER SISTER DIED NOBODY STEPPED ON A LAND MINE MORE FOOD FOR ME	__label__very_offensive
STARTED FROM THE BOTTOM NOW WE HERE BOTTOM AGAIN	__label__slight
WHY JACKP BECAUSE BOYANCY IN' STUFF WHY BEN? BECAUSE REMEMBER TITANIC imgflip.com	__label__slight
Cancer doesn't just take your life  it takes your jobs.	__label__slight
"“Do you want to spend the rest of your life selling sugared water or do you want a chance to change the world?"""	__label__very_offensive
Be a yardstick of quality. Some people aren't used to an environment where excellence is expected. STEVE JOBS YOUR DIGITAL AfORMULA Learn how to grow your influence on social media: https://stevenaitchison.mykaja bi.com/p/your-digital-formulacoaches	__label__slight
HEY MACS WHERE IS YOUR GOD NOW? memegenerator.net	__label__slight
With the sad news that Steve Jobs died  there is need for a great new visionary.	__label__slight
DAT FACE THAT YOU MAKE WHEN WAKELL YOU REALISE THAT YOUR LIFEIS ROLLING AWAY imgflip.com	__label__very_offensive
Ginger seal craves sustenance No sole to be found	__label__very_offensive
ON MY WAY TO WORK I CUTA GUY OFF AND GIVE HIM THE FINGER	__label__very_offensive
INTERVIEWER ASKED NAVY SEAL IF THEY HAVE TO LEARN FOREIGN LANGUAGES LIKE GREEN BERETS NO MA'AM WHEN THEY SEND US OVER THERE IT'S NOT TO TALK imgflip.com	__label__very_offensive
DO YOU WANT TO GET IT BANNED  LIKE THE PUFFIN? BECAUSE THAT'S HOW YOU  GET IT BANNED  LIKE THE PUFFIN.	__label__slight
CUTTING WRAPPING PAPER SCISSORS START TO GLIDE Unbelievable & Ludicrus Christmas SEAL.	__label__very_offensive
When you go and check the fridge and theres no food left	__label__slight
FROGMAN? NICE NICKNAME Quickmeme.com	__label__slight
CHOICE HAT BRO! imgflip.com	__label__very_offensive
I WAS TOP OF MY CLASS AT NAVY SEAL TRAINING AT NAVY SEAL TRAINING imgflip.com	__label__slight
HAVE DREAM WHERE I KILL SOME DUDE AND HAPHAZARDLY GET RID OF THE BODY mgom WAKE UP AND REALISE I'M NOT A MURDERER imgflip.com Scumbag brain and satisfied seal make strange bedfellows.	__label__very_offensive
EX AL Me making sorry eyes My mum sarcastically with insulting a lady who is just trying to do her job	__label__slight
I have surprise for you Shared on PRUSUNOD The Internet Scavengers	__label__slight
SEXIST? VIA 9GAG.COM THIS LADY WHO CALLED ME OUT FOR MY HISTORY OF MISOGYNISTIC COMMENTS MUST BE ON HER PERIOD	__label__slight
BUT GOD SHE WON'T EVEN MAKE ME A SANDWICH... constant updates of the best funny pictures on the web LOLSNAPS.com	__label__slight
IT TOOK YOU 10 MINUTES TO GET HOME GOOGLE MAPS SAYS IT TAKES 8. WHO IS SHE?!	__label__slight
FEMINISM. YOU KEEP USING THAT WORD I DO NOT THINK IT MEANS WHAT YOU THINK IT MEANS memegenerator.net	__label__slight
SAID SHE WANTS TO HEAR THE OCEAN TOLD HER I'D BRING BACK A SEASHELL mematic.net	__label__slight
When u texted ur man 3 min ago and he still hasn't responded @daddyissues entube I'm single right now.	__label__slight
SILLY GIRL Art Base 3-6|Dec THATS NOT THE KITCHEN memecenter.com Mamelenler	__label__very_offensive
YOU TELL ME ...DADDIES LOVE BOOBIES TOO?	__label__very_offensive
"THE APPJUICE ""I RESPECT YOU. YOU ARE AN EXCELLENT ATTORNEY AND A VALUABLE MEMBER OF THIS FIRM."" usa"	__label__very_offensive
Harvey Specter @ HarveyLLB SUITS is like Splitsvilla.	__label__slight
HAPPY BIRTHDAY GURL! memegenerator.net	__label__very_offensive
DAMAGED PEOPLE ARE STRONG BECAUSE THEY KNOW HOW TO SURVIVE. INSTAGRAM WORDS2SUCCESS	__label__slight
THIS IS HOW I FUCK THE SKY	__label__slight
IT'S SIMPLE WE KILL SPIDER-MAN quickmeme.com	__label__very_offensive
SPIDER-MAN JUST WATCHED INFINITY WAR imgflip.com	__label__very_offensive
Oh god why did I order the vindaloo curry? MARVEL.COM	__label__slight
SO WHO IS GOING TO SPIDERMAN BLOW-UP SPIDERMAN?	__label__slight
I'M NOT GONNA LIE KID THERE WAS NEVER ANY CANDY	__label__slight
You've been hit by You've been struck by A smooth criminal Funny being.com	__label__very_offensive
I prefer the real aunt may. I said the real aunt may. Perfection.	__label__slight
HERE'S HOW DEADPOOL MADE HIS DREAM COME TRUE AAAARGH!!!	__label__very_offensive
For the last time Peter I'm not Hitler Stop asking for autographs	__label__slight
THIS IS THE LAST TIME I DROP ACID WITH SALVADOR DALI.	__label__slight
YOU'RE NOT MY REAL DAD spiderman memes 60s spiderman memes  funny spiderman memes	__label__hateful_offensive
I LIKE SPORTS I COULD PLAY SOMETHING IN SPORTS quickmeme.com	__label__slight
3 BALLS WITH ONE KICK  MUST BE A RECORD Trendingnuts.com	__label__very_offensive
MAKE FUN OF MY UNIBROW ONE MORE TIME! KENTUCKY SPORTS MEMES	__label__slight
DAD. WHAT'S TAKING THE GAME WINNING SHOT? I DON'T KNOW SON. I'M LEBRON JAMES	__label__hateful_offensive
"CR7: ""THE GOD OF FOOTBALL SENT ME TO BE THE BEST!"" MESSI MESSI: ""I DONT REMEMBER SENDING Trendingnuts.com"	__label__slight
EUROPE We have to cancel this match Snowing is too hard. FOUND AT VERYFUNNYPICS.EU Meanwhile in Russia	__label__hateful_offensive
YOUR KID IS THE BEST ON HIS LITTLE LEAGUE TEAM? TELL ME MORE ABOUT HIS FUTURE IN MLB. imgflip.com	__label__slight
JUST HAD THE CRAZIEST DREAM CSN H MUUT FACEBOOK.COM/THEMLBNEMES dis THAT I ACTUALLY WENT TO AN ASTROS GAME	__label__slight
Od winter book.com/NBAMCAMINE DON'T BRING A GIRL TO THE NBA PLAYOFFS SHE'LL GET BORED	__label__slight
THAT MOMENT WHEN TOM JUST HAD ENOUGH OF JERRY'S CRAP imgflip.com	__label__very_offensive
When you get tired of going to work every day so you start hitting up the golf course looking for old rich men like	__label__very_offensive
"What if the ""10 Year Challenge"" was created by Zuckerberg to optimise the face recognition software"	__label__slight
9 Year olds seeing others doing the 10 years challenge	__label__slight
HOW TO BE A DESIRABLE MANIN: 2009. 2019	__label__slight
"Donald J. Trump OrealDonald Trump ""We build too many walls and not enough bridges."" - Isaac Newton 4:11 PM Oct 7 2013 Twitter Web Client 79.8K Retweets 66.2K Likes Mod. this whole operation was your idea"	__label__slight
"DEAR AVENGERS MOVIE CONSPIRACY THEORISTS... THE ""QUANTUM REALM"" DOESN'T WORK THAT WAY! NOW SHUT THE #@[% UP AND GO TO BED!"	__label__very_offensive
IG:@marvel_memes WHAT GIVES YOU THE RIGHT? WHAT'S THE DIFFERENCE BETWEEN YOU AND US? @marvel memes I GET TO BE IN THE AVENGERS	__label__slight
yes i really love thor and loki	__label__very_offensive
Tony looks on in terror as Thanos unzips his pants  revealing two more Infinity Stones	__label__slight
Tell Thanos I'm coming MARVEL STUDIOS AVENGERS 4 REVENGE OF THE WICK	__label__slight
. - DC OR MARVEL? MEME MADE BY THE FB PG DC/MARVEL-COMICS/MOVIES I LOVE BOTH! I CAN'T CHOOSE AND I WONTI THATS WHAT I'M TALKING ABOUT! IT WAS A TRICK QUESTION! ~Agent Coulson	__label__hateful_offensive
"EVERY TIME I ALREADY KNOW A VERSE ""I UNDERSTOOD THAT REFERENCE"""	__label__very_offensive
YOU ARE BEAUTIFUL GO TO HELL YOU ARE REALLY POWERFUL GO TO HELL CAN YOU LEAD THE AVENGERS REALLY? GO TO HELL	__label__very_offensive
YOU TELL THAT PENGUIN WITH THE BAD WEAVE KEEP MESSING WITH AYOOLA  AND THAT WEAVE WILL BE EATING PAVEMENT! quickmeme.com	__label__slight
GIMME THAT CAPRI SUN BITCH IM THIRSTY quickmeme.com	__label__slight
THAT AWKWARD MOMENT WHEN YOU REALIZE... YOUR OB'S BEEN SACKED MORE THAN THE NUMBER OF POINTS YOU'VE SCORED ALL PRESEASON	__label__very_offensive
LEAVE THE GUN TAKE THE CHEERIOS MC memecenter.com/godfather85	__label__very_offensive
MOM SAID ALCOHOL IS THE ENEMY JESUS SAID LOVE THY ENEMY THE MATTER IS RESOLVED CrazyHyence.com	__label__slight
THE ONLY B'WORD YOU SHOULD CALL A WOMAN IS BEAUTIFUL BITCHES LOVE BEING CALLED BEAUTIFUL memegenerator.com	__label__slight
ANIMATED MEMES WAIT FOR IT...	__label__slight
WHAT DO YOU CALL A COW FALLING OFF A CLIFF? LEDGE-END _WAIT FOR IT DAIRY MEMES & FUNNY PICS FRABZ.COM	__label__very_offensive
HIMYM fact #7 scenesofhimym There are only 12 times during the series when Barney doesn't suit up. Did you know? #HIMYM. https://t.co/KWECEPESMs	__label__slight
CHALLENGE ACCEPTED imgflip.com	__label__slight
I TRIED TO BE FRIENDZONED	__label__very_offensive
ROBIN THICKE rcedes Ishio IS THE REAL BARNEY STINSON imgflip.com	__label__very_offensive
THAT FACE YOUR FRIEND GIVES YOU WHEN YOUR CRUSH WALKS INTO THE ROOM.	__label__very_offensive
YOU LYING LET ME	__label__slight
WHY HELLO THER memegenerator.net	__label__very_offensive
Ability When you can make three generations of people laugh their socks off	__label__slight
Baby Mr. Bean Funny Picture	__label__very_offensive
WHICH SEAT CAN I TAKE? NOT THIS ONE	__label__slight
THAT ONE MOMENT WHEN YOU FIND OUT WHATI MEAN memecrunch.com	__label__slight
ONBAMemes AKERS a lakception.cow/4506 Kobe Mr. Bean Bryant! Credit: Basketball Pics	__label__slight
MR BEAN AND DR. HOUSE Double the Epicness We Know Memes	__label__slight
YOUR FACE MemeCenter.com WHEN THERES A SUBSTITUTE IN MATH CLASS	__label__very_offensive
Mr. Bean: NBA Edition! Credit - Alfred Justin Montoya	__label__slight
amycalvins These Pics Of Mr. Bean Photoshopped Into Pop Culture Moments Are Hysterical Trollery	__label__very_offensive
No matter how old I grow o _Dekh Bhai 'I will always enjoy watching Mr.Bean Double Tap if you've seen his show #AmazingComedian #SoTalented #inspiration. @ommy_007	__label__slight
Thanks for making our childhood awesome Mr. Bean.	__label__slight
The new Mr Bean figure is pretty life like	__label__slight
I STILL KNOW NOTHING! 2017	__label__very_offensive
"Create a hashtag for this... ""NO TIME TO EXPLAIN. GRAB ALL THE HELICHRYSUM YOU HAVE AND HOP IN THE CAR!!!"" ESSENTIALOILSTYLE.COM"	__label__slight
YOU'RE THE BEST AROUND. NOTHING'S EVER GONNA KEEP YOU DOWN. Ralph Macchio	__label__hateful_offensive
Tuesday is Mardi Gras Wednesday is Valentine's Friday is the Chinese New Year To those who celebrate in full force; I'll be waiting for you at the end of the week with a digestive blend. ESSENTIALOILSTYLE.COM	__label__very_offensive
LESS MORE TALKING PLANNING SODA JUNK FOOD COMPLAINING WORRYING DOUBTING LAZING AROUND FROWNING INSECURITY WEAKNESS IGNORANCE HATE UNGRATEFULNESS LISTENING DOING TEA SALADS ENCOURAGING HOPING BELIEVING WORKING OUT SMILING TRUST CONFIDENCE UNDERSTANDING LOVE GRATITUDE An easy guide to making the rest of 2017 the best of 2017...	__label__slight
